"","LG_ID","NAME","AUDIT_YEAR","CM_FUND_TYPE_ID","GO_DEBT","REVENUE_DEBT","OTHER_DEBT","debt"
"1",62023,"Grover, Town of",2012,2,0,0,17134,17134
"2",62023,"Grover, Town of",2012,3,0,0,295948,295948
"3",62023,"Grover, Town of",2011,2,0,0,19414,19414
"4",62023,"Grover, Town of",2011,3,0,0,0,0
"5",62023,"Grover, Town of",2010,2,0,0,21581,21581
"6",62023,"Grover, Town of",2010,3,0,0,0,0
"7",62023,"Grover, Town of",2014,2,0,0,0,0
"8",62023,"Grover, Town of",2014,3,0,0,285771,285771
"9",62023,"Grover, Town of",2013,2,0,0,0,0
"10",62023,"Grover, Town of",2013,3,0,0,290910,290910
"11",60015,"Woodland Park, City of",2011,2,0,1090000,1351917,2441917
"12",60015,"Woodland Park, City of",2011,3,0,530000,640236,1170236
"13",60015,"Woodland Park, City of",2010,2,0,1340000,1570030,2910030
"14",60015,"Woodland Park, City of",2010,3,0,780000,705000,1485000
"15",60015,"Woodland Park, City of",2014,2,0,290000,611241,901241
"16",60015,"Woodland Park, City of",2014,3,0,0,554523,554523
"17",60015,"Woodland Park, City of",2013,2,0,570000,873447,1443447
"18",60015,"Woodland Park, City of",2013,3,0,0,583664,583664
"19",60015,"Woodland Park, City of",2012,3,0,270000,612231,882231
"20",60015,"Woodland Park, City of",2012,2,0,835000,1120022,1955022
"21",57017,"Sawpit, Town of",2010,2,0,0,0,0
"22",57017,"Sawpit, Town of",2013,2,0,0,0,0
"23",57017,"Sawpit, Town of",2012,2,0,0,0,0
"24",57017,"Sawpit, Town of",2014,2,0,0,0,0
"25",57017,"Sawpit, Town of",2011,2,0,0,0,0
"26",64029,"Brighton, City of",2010,1,2465000,30165000,1784750,34414750
"27",64029,"Brighton, City of",2011,1,485000,30165000,1458336,32108336
"28",64029,"Brighton, City of",2012,1,0,30015000,1121392,31136392
"29",64029,"Brighton, City of",2014,1,0,25580000,400121,25980121
"30",64029,"Brighton, City of",2013,1,0,29310000,768653,30078653
"31",62043,"Milliken, Town of",2011,2,0,0,779419,779419
"32",62043,"Milliken, Town of",2011,3,0,0,4219367,4219367
"33",62043,"Milliken, Town of",2010,2,0,0,794683,794683
"34",62043,"Milliken, Town of",2010,3,0,0,4503573,4503573
"35",62043,"Milliken, Town of",2012,2,0,0,763421,763421
"36",62043,"Milliken, Town of",2012,3,0,0,3929696,3929696
"37",62043,"Milliken, Town of",2013,2,0,0,746607,746607
"38",62043,"Milliken, Town of",2013,3,0,0,3640024,3640024
"39",62043,"Milliken, Town of",2014,2,0,0,729034,729034
"40",62043,"Milliken, Town of",2014,3,0,0,3344887,3344887
"41",64085,"Littleton, City of",2010,3,1174874,0,40998728,42173602
"42",64085,"Littleton, City of",2011,3,520030,0,38555832,39075862
"43",64085,"Littleton, City of",2014,3,0,0,31474210,31474210
"44",64085,"Littleton, City of",2012,3,0,0,36089924,36089924
"45",64085,"Littleton, City of",2013,3,0,0,33839567,33839567
"46",34015,"Ignacio, Town of",2010,2,0,0,335896,335896
"47",34015,"Ignacio, Town of",2010,3,0,0,355537,355537
"48",34015,"Ignacio, Town of",2011,2,0,0,323060,323060
"49",34015,"Ignacio, Town of",2011,3,0,336300,4877,341177
"50",34015,"Ignacio, Town of",2014,2,0,0,291450,291450
"51",34015,"Ignacio, Town of",2014,3,0,315728,0,315728
"52",34015,"Ignacio, Town of",2012,2,0,0,291661,291661
"53",34015,"Ignacio, Town of",2012,3,0,329728,3412,333140
"54",34015,"Ignacio, Town of",2013,2,0,0,291450,291450
"55",34015,"Ignacio, Town of",2013,3,0,322828,0,322828
"56",31003,"Haswell, Town of",2011,2,0,0,44629,44629
"57",31003,"Haswell, Town of",2010,2,0,0,46287,46287
"58",31003,"Haswell, Town of",2013,2,0,0,41036,41036
"59",31003,"Haswell, Town of",2012,2,0,0,42913,42913
"60",31003,"Haswell, Town of",2014,2,0,0,39096,39096
"61",15020,"Hotchkiss, Town of",2012,2,0,0,832693,832693
"62",15020,"Hotchkiss, Town of",2012,3,0,0,521645,521645
"63",15020,"Hotchkiss, Town of",2011,2,0,0,610139,610139
"64",15020,"Hotchkiss, Town of",2011,3,0,0,545761,545761
"65",15020,"Hotchkiss, Town of",2010,2,0,0,457533,457533
"66",15020,"Hotchkiss, Town of",2010,3,0,0,569947,569947
"67",15020,"Hotchkiss, Town of",2014,2,0,0,479153,479153
"68",15020,"Hotchkiss, Town of",2014,3,0,0,455813,455813
"69",15020,"Hotchkiss, Town of",2013,2,0,0,401966,401966
"70",15020,"Hotchkiss, Town of",2013,3,0,0,482620,482620
"71",15025,"Paonia, Town of",2010,2,0,0,0,0
"72",15025,"Paonia, Town of",2010,3,0,0,1822585,1822585
"73",15025,"Paonia, Town of",2011,2,0,0,289977,289977
"74",15025,"Paonia, Town of",2011,3,0,0,1801045,1801045
"75",15025,"Paonia, Town of",2013,2,0,0,315701,315701
"76",15025,"Paonia, Town of",2013,3,0,0,1755065,1755065
"77",15025,"Paonia, Town of",2014,2,0,0,3284500,3284500
"78",15025,"Paonia, Town of",2014,3,0,0,1730539,1730539
"79",15025,"Paonia, Town of",2012,2,0,0,335167,335167
"80",15025,"Paonia, Town of",2012,3,0,0,1778552,1778552
"81",5011,"Springfield, Town of",2010,2,0,0,204671,204671
"82",5011,"Springfield, Town of",2010,3,0,0,561439,561439
"83",5011,"Springfield, Town of",2013,2,0,0,149115,149115
"84",5011,"Springfield, Town of",2013,3,0,0,449954,449954
"85",5011,"Springfield, Town of",2011,2,0,0,186970,186970
"86",5011,"Springfield, Town of",2011,3,0,0,524689,524689
"87",5011,"Springfield, Town of",2014,2,0,0,128885,128885
"88",5011,"Springfield, Town of",2014,3,0,0,411936,411936
"89",5011,"Springfield, Town of",2012,2,0,0,168464,168464
"90",5011,"Springfield, Town of",2012,3,0,0,487533,487533
"91",5016,"Two Buttes, Town of",2010,1,0,0,0,0
"92",5016,"Two Buttes, Town of",2013,1,0,0,0,0
"93",5016,"Two Buttes, Town of",2011,1,0,0,0,0
"94",5016,"Two Buttes, Town of",2012,1,0,0,0,0
"95",5016,"Two Buttes, Town of",2014,1,0,0,0,0
"96",64060,"Erie, Town of",2012,2,0,32927936,30906204,63834140
"97",64060,"Erie, Town of",2012,3,0,19547506,3277901,22825407
"98",64060,"Erie, Town of",2010,2,0,24846000,40540000,65386000
"99",64060,"Erie, Town of",2010,3,0,20040000,4496629,24536629
"100",64060,"Erie, Town of",2011,2,0,34268045,31085504,65353549
"101",64060,"Erie, Town of",2011,3,0,19770000,4176462,23946462
"102",64060,"Erie, Town of",2014,2,0,30724113,26517666,57241779
"103",64060,"Erie, Town of",2014,3,0,18960904,2718981,21679885
"104",64060,"Erie, Town of",2013,2,0,32398708,28295000,60693708
"105",64060,"Erie, Town of",2013,3,0,19260372,3002204,22262576
"106",62051,"Raymer, Town of",2011,2,0,0,0,0
"107",62051,"Raymer, Town of",2010,2,0,0,0,0
"108",62051,"Raymer, Town of",2012,2,0,0,0,0
"109",62051,"Raymer, Town of",2014,2,0,0,0,0
"110",62051,"Raymer, Town of",2013,2,0,0,0,0
"111",57008,"Ophir, Town of",2011,2,0,0,462500,462500
"112",57008,"Ophir, Town of",2010,2,0,0,487500,487500
"113",57008,"Ophir, Town of",2012,2,0,0,437500,437500
"114",57008,"Ophir, Town of",2013,2,0,0,412500,412500
"115",57008,"Ophir, Town of",2014,2,0,0,387500,387500
"116",45001,"Cheraw, Town of",2012,2,0,0,9267,9267
"117",45001,"Cheraw, Town of",2012,3,0,0,0,0
"118",45001,"Cheraw, Town of",2011,2,0,0,14557,14557
"119",45001,"Cheraw, Town of",2011,3,0,0,0,0
"120",45001,"Cheraw, Town of",2010,2,0,0,19596,19596
"121",45001,"Cheraw, Town of",2010,3,0,0,0,0
"122",45001,"Cheraw, Town of",2013,2,0,0,0,0
"123",45001,"Cheraw, Town of",2013,3,0,0,0,0
"124",45001,"Cheraw, Town of",2014,2,0,0,0,0
"125",45001,"Cheraw, Town of",2014,3,0,0,0,0
"126",42004,"Cortez, City of",2011,2,0,0,4551463,4551463
"127",42004,"Cortez, City of",2010,2,0,0,4663514,4663514
"128",42004,"Cortez, City of",2012,2,0,0,4424991,4424991
"129",42004,"Cortez, City of",2014,2,0,0,4166733,4166733
"130",42004,"Cortez, City of",2013,2,0,0,4298979,4298979
"131",64266,"Johnstown, Town of",2011,2,0,1876000,1426791,3302791
"132",64266,"Johnstown, Town of",2011,3,0,0,0,0
"133",64266,"Johnstown, Town of",2010,2,0,2092000,1480286,3572286
"134",64266,"Johnstown, Town of",2010,3,0,0,0,0
"135",64266,"Johnstown, Town of",2014,2,0,0,0,0
"136",64266,"Johnstown, Town of",2014,3,0,0,0,0
"137",64266,"Johnstown, Town of",2012,2,0,1648000,1371156,3019156
"138",64266,"Johnstown, Town of",2012,3,0,0,0,0
"139",64266,"Johnstown, Town of",2013,2,0,1408000,0,1408000
"140",64266,"Johnstown, Town of",2013,3,0,0,0,0
"141",7033,"Nederland, Town of",2012,3,0,0,3847699,3847699
"142",7033,"Nederland, Town of",2012,2,0,0,2175133,2175133
"143",7033,"Nederland, Town of",2011,2,0,0,2271780,2271780
"144",7033,"Nederland, Town of",2011,3,0,0,3961090,3961090
"145",7033,"Nederland, Town of",2010,2,0,0,2500000,2500000
"146",7033,"Nederland, Town of",2010,3,0,0,0,0
"147",7033,"Nederland, Town of",2013,3,0,0,3655760,3655760
"148",7033,"Nederland, Town of",2013,2,0,0,2064525,2064525
"149",7033,"Nederland, Town of",2014,3,0,0,3465222,3465222
"150",7033,"Nederland, Town of",2014,2,0,0,1953292,1953292
"151",38005,"Fleming, Town of",2010,2,0,0,0,0
"152",38005,"Fleming, Town of",2010,3,0,0,0,0
"153",38005,"Fleming, Town of",2011,2,0,0,0,0
"154",38005,"Fleming, Town of",2011,3,0,0,0,0
"155",38005,"Fleming, Town of",2013,2,0,0,0,0
"156",38005,"Fleming, Town of",2013,3,0,0,0,0
"157",38005,"Fleming, Town of",2012,2,0,0,0,0
"158",38005,"Fleming, Town of",2012,3,0,0,0,0
"159",38005,"Fleming, Town of",2014,2,0,0,0,0
"160",38005,"Fleming, Town of",2014,3,0,0,0,0
"161",53005,"Monte Vista, City of",2011,1,0,0,1457279,1457279
"162",53005,"Monte Vista, City of",2010,1,0,0,1109161,1109161
"163",53005,"Monte Vista, City of",2014,2,0,0,1610064,1610064
"164",53005,"Monte Vista, City of",2014,3,0,0,302231,302231
"165",53005,"Monte Vista, City of",2013,2,0,0,1144642,1144642
"166",53005,"Monte Vista, City of",2013,3,0,0,361325,361325
"167",53005,"Monte Vista, City of",2012,1,0,0,1574256,1574256
"168",54005,"Hayden, Town of",2010,1,0,0,921626,921626
"169",54005,"Hayden, Town of",2012,1,0,0,1367059,1367059
"170",54005,"Hayden, Town of",2011,1,0,0,844421,844421
"171",54005,"Hayden, Town of",2014,1,0,0,2086935,2086935
"172",54005,"Hayden, Town of",2013,1,0,0,1282782,1282782
"173",48004,"Haxtun, Town of",2010,2,0,0,0,0
"174",48004,"Haxtun, Town of",2010,3,0,0,262279,262279
"175",48004,"Haxtun, Town of",2011,2,0,0,0,0
"176",48004,"Haxtun, Town of",2011,3,0,0,248578,248578
"177",48004,"Haxtun, Town of",2014,2,0,0,0,0
"178",48004,"Haxtun, Town of",2014,3,0,0,205906,205906
"179",48004,"Haxtun, Town of",2013,2,0,0,0,0
"180",48004,"Haxtun, Town of",2013,3,0,0,220396,220396
"181",48004,"Haxtun, Town of",2012,2,0,0,0,0
"182",48004,"Haxtun, Town of",2012,3,0,0,234618,234618
"183",52015,"Rangely, Town of",2010,3,0,0,189652,189652
"184",52015,"Rangely, Town of",2010,2,0,0,457386,457386
"185",52015,"Rangely, Town of",2011,3,0,0,172309,172309
"186",52015,"Rangely, Town of",2011,2,0,0,415558,415558
"187",52015,"Rangely, Town of",2012,3,0,0,154132,154132
"188",52015,"Rangely, Town of",2012,2,0,0,371723,371723
"189",52015,"Rangely, Town of",2013,3,0,0,135084,135084
"190",52015,"Rangely, Town of",2013,2,0,0,1825783,1825783
"191",52015,"Rangely, Town of",2014,3,0,0,115122,115122
"192",52015,"Rangely, Town of",2014,2,0,0,1730878,1730878
"193",62011,"Evans, City of",2010,2,0,0,0,0
"194",62011,"Evans, City of",2010,3,0,0,742979,742979
"195",62011,"Evans, City of",2011,2,0,0,0,0
"196",62011,"Evans, City of",2011,3,0,0,662406,662406
"197",62011,"Evans, City of",2014,2,0,0,1409211,1409211
"198",62011,"Evans, City of",2014,3,0,0,403937,403937
"199",62011,"Evans, City of",2012,2,0,0,0,0
"200",62011,"Evans, City of",2012,3,0,0,580873,580873
"201",62011,"Evans, City of",2013,2,0,0,1500000,1500000
"202",62011,"Evans, City of",2013,3,0,0,492929,492929
"203",62029,"Hudson, Town of",2011,2,552400,0,934444,1486844
"204",62029,"Hudson, Town of",2011,3,0,0,3545000,3545000
"205",62029,"Hudson, Town of",2012,2,539200,0,906692,1445892
"206",62029,"Hudson, Town of",2012,3,0,0,3500826,3500826
"207",62029,"Hudson, Town of",2010,2,565000,0,961652,1526652
"208",62029,"Hudson, Town of",2010,3,0,0,3488654,3488654
"209",62029,"Hudson, Town of",2014,2,511000,0,849512,1360512
"210",62029,"Hudson, Town of",2014,3,0,0,3408090,3408090
"211",62029,"Hudson, Town of",2013,2,525400,0,878385,1403785
"212",62029,"Hudson, Town of",2013,3,0,0,3455206,3455206
"213",62033,"Keenesburg, Town of",2010,2,0,0,1085249,1085249
"214",62033,"Keenesburg, Town of",2010,3,0,0,50731,50731
"215",62033,"Keenesburg, Town of",2011,2,0,0,1062681,1062681
"216",62033,"Keenesburg, Town of",2011,3,0,0,48927,48927
"217",62033,"Keenesburg, Town of",2012,2,0,0,1039266,1039266
"218",62033,"Keenesburg, Town of",2012,3,0,0,47034,47034
"219",62033,"Keenesburg, Town of",2013,2,0,0,1004288,1004288
"220",62033,"Keenesburg, Town of",2013,3,0,0,45046,45046
"221",62033,"Keenesburg, Town of",2014,2,0,0,967355,967355
"222",62033,"Keenesburg, Town of",2014,3,0,0,42958,42958
"223",62035,"Kersey, Town of",2011,2,0,0,0,0
"224",62035,"Kersey, Town of",2011,3,0,0,1542897,1542897
"225",62035,"Kersey, Town of",2010,2,0,0,0,0
"226",62035,"Kersey, Town of",2010,3,0,0,1623862,1623862
"227",62035,"Kersey, Town of",2013,2,0,0,0,0
"228",62035,"Kersey, Town of",2013,3,0,0,1372028,1372028
"229",62035,"Kersey, Town of",2014,2,0,0,113480,113480
"230",62035,"Kersey, Town of",2014,3,0,0,1281906,1281906
"231",62035,"Kersey, Town of",2012,2,0,0,0,0
"232",62035,"Kersey, Town of",2012,3,0,0,1458988,1458988
"233",62037,"La Salle, Town of",2010,2,0,0,3e+05,3e+05
"234",62037,"La Salle, Town of",2010,3,0,0,0,0
"235",62037,"La Salle, Town of",2011,2,0,0,155000,155000
"236",62037,"La Salle, Town of",2011,3,0,0,0,0
"237",62037,"La Salle, Town of",2013,2,0,0,0,0
"238",62037,"La Salle, Town of",2013,3,0,0,0,0
"239",62037,"La Salle, Town of",2012,2,0,0,0,0
"240",62037,"La Salle, Town of",2012,3,0,0,0,0
"241",62037,"La Salle, Town of",2014,2,0,0,0,0
"242",62037,"La Salle, Town of",2014,3,0,0,0,0
"243",62038,"Lochbuie, Town of",2010,2,0,2289448,0,2289448
"244",62038,"Lochbuie, Town of",2010,3,0,194000,452218,646218
"245",62038,"Lochbuie, Town of",2011,2,0,2220425,0,2220425
"246",62038,"Lochbuie, Town of",2011,3,0,0,346357,346357
"247",62038,"Lochbuie, Town of",2013,2,0,2080000,0,2080000
"248",62038,"Lochbuie, Town of",2013,3,0,0,120458,120458
"249",62038,"Lochbuie, Town of",2014,2,0,1970000,0,1970000
"250",62038,"Lochbuie, Town of",2014,3,0,0,0,0
"251",62038,"Lochbuie, Town of",2012,2,0,2180000,0,2180000
"252",62038,"Lochbuie, Town of",2012,3,0,0,235839,235839
"253",62040,"Mead, Town of",2011,3,0,0,2545000,2545000
"254",62040,"Mead, Town of",2010,3,0,0,2660000,2660000
"255",62040,"Mead, Town of",2013,3,0,0,2310000,2310000
"256",62040,"Mead, Town of",2014,3,0,0,2185000,2185000
"257",62040,"Mead, Town of",2012,3,0,0,2430000,2430000
"258",62045,"Nunn, Town of",2011,2,0,0,535637,535637
"259",62045,"Nunn, Town of",2010,2,0,0,131120,131120
"260",62045,"Nunn, Town of",2013,2,0,0,480547,480547
"261",62045,"Nunn, Town of",2014,2,0,0,445746,445746
"262",62045,"Nunn, Town of",2012,2,0,0,514249,514249
"263",62046,"Pierce, Town of",2011,2,0,0,0,0
"264",62046,"Pierce, Town of",2011,3,0,0,781091,781091
"265",62046,"Pierce, Town of",2012,3,0,0,741682,741682
"266",62046,"Pierce, Town of",2012,2,0,0,0,0
"267",62046,"Pierce, Town of",2010,2,0,0,0,0
"268",62046,"Pierce, Town of",2010,3,0,0,819772,819772
"269",62046,"Pierce, Town of",2013,2,0,0,0,0
"270",62046,"Pierce, Town of",2013,3,0,0,701530,701530
"271",62046,"Pierce, Town of",2014,2,0,0,0,0
"272",62046,"Pierce, Town of",2014,3,0,0,660622,660622
"273",62050,"Platteville, Town of",2010,2,0,0,290000,290000
"274",62050,"Platteville, Town of",2010,3,0,0,0,0
"275",62050,"Platteville, Town of",2012,2,0,0,0,0
"276",62050,"Platteville, Town of",2012,3,0,0,0,0
"277",62050,"Platteville, Town of",2013,2,0,0,0,0
"278",62050,"Platteville, Town of",2013,3,0,0,0,0
"279",62050,"Platteville, Town of",2011,2,0,0,225000,225000
"280",62050,"Platteville, Town of",2011,3,0,0,0,0
"281",62050,"Platteville, Town of",2014,2,0,0,0,0
"282",62050,"Platteville, Town of",2014,3,0,0,0,0
"283",62053,"Severance, Town of",2010,2,0,0,214872,214872
"284",62053,"Severance, Town of",2010,3,0,0,630139,630139
"285",62053,"Severance, Town of",2012,2,0,0,0,0
"286",62053,"Severance, Town of",2012,3,0,0,0,0
"287",62053,"Severance, Town of",2014,2,0,0,0,0
"288",62053,"Severance, Town of",2014,3,0,0,0,0
"289",62053,"Severance, Town of",2013,2,0,0,0,0
"290",62053,"Severance, Town of",2013,3,0,0,0,0
"291",62053,"Severance, Town of",2011,2,0,0,146110,146110
"292",62053,"Severance, Town of",2011,3,0,0,597987,597987
"293",62003,"Ault, Town of",2011,2,0,0,0,0
"294",62003,"Ault, Town of",2011,3,0,0,1093681,1093681
"295",62003,"Ault, Town of",2010,2,0,0,0,0
"296",62003,"Ault, Town of",2010,3,0,0,1159586,1159586
"297",62003,"Ault, Town of",2012,2,0,0,0,0
"298",62003,"Ault, Town of",2012,3,0,0,995066,995066
"299",62003,"Ault, Town of",2014,2,0,0,0,0
"300",62003,"Ault, Town of",2014,3,0,0,862003,862003
"301",62003,"Ault, Town of",2013,2,0,0,0,0
"302",62003,"Ault, Town of",2013,3,0,0,929114,929114
"303",62007,"Dacono, City of",2011,2,350000,0,2369980,2719980
"304",62007,"Dacono, City of",2010,2,525000,0,2559818,3084818
"305",62007,"Dacono, City of",2014,2,0,0,1772092,1772092
"306",62007,"Dacono, City of",2013,2,140000,0,1979883,2119883
"307",62007,"Dacono, City of",2012,2,165000,0,2171339,2336339
"308",62008,"Eaton, Town of",2011,2,0,0,1819167,1819167
"309",62008,"Eaton, Town of",2011,3,0,0,4052318,4052318
"310",62008,"Eaton, Town of",2010,2,0,0,1940000,1940000
"311",62008,"Eaton, Town of",2010,3,0,0,4277319,4277319
"312",62008,"Eaton, Town of",2012,2,0,0,1693333,1693333
"313",62008,"Eaton, Town of",2012,3,0,0,3809709,3809709
"314",62008,"Eaton, Town of",2013,2,0,0,1562500,1562500
"315",62008,"Eaton, Town of",2013,3,0,0,3601951,3601951
"316",62008,"Eaton, Town of",2014,2,0,0,1465964,1465964
"317",62008,"Eaton, Town of",2014,3,0,0,3389108,3389108
"318",62012,"Firestone, Town of",2011,2,0,0,16309,16309
"319",62012,"Firestone, Town of",2010,2,0,0,27892,27892
"320",62012,"Firestone, Town of",2014,2,0,0,0,0
"321",62012,"Firestone, Town of",2012,2,0,0,34740,34740
"322",62012,"Firestone, Town of",2013,2,0,0,15782,15782
"323",62014,"Fort Lupton, City of",2010,1,0,12703300,4556513,17259813
"324",62014,"Fort Lupton, City of",2011,1,0,12325400,6015374,18340774
"325",62014,"Fort Lupton, City of",2014,1,0,11082900,2608381,13691281
"326",62014,"Fort Lupton, City of",2012,1,0,11931800,5208471,17140271
"327",62014,"Fort Lupton, City of",2013,1,0,11518400,2714804,14233204
"328",62016,"Frederick, Town of",2010,2,0,0,788710,788710
"329",62016,"Frederick, Town of",2011,2,0,0,742970,742970
"330",62016,"Frederick, Town of",2012,2,0,0,695136,695136
"331",62016,"Frederick, Town of",2013,2,0,0,0,0
"332",62016,"Frederick, Town of",2014,2,0,0,0,0
"333",62020,"Gilcrest, Town of",2010,3,0,0,72380,72380
"334",62020,"Gilcrest, Town of",2010,2,184100,84000,88005,356105
"335",62020,"Gilcrest, Town of",2011,2,173300,75000,85124,333424
"336",62020,"Gilcrest, Town of",2011,3,0,0,68687,68687
"337",62020,"Gilcrest, Town of",2012,2,161800,66000,82098,309898
"338",62020,"Gilcrest, Town of",2012,3,0,0,64809,64809
"339",62020,"Gilcrest, Town of",2014,2,136700,46000,75585,258285
"340",62020,"Gilcrest, Town of",2014,3,0,0,56462,56462
"341",62020,"Gilcrest, Town of",2013,2,149600,56000,78921,284521
"342",62020,"Gilcrest, Town of",2013,3,0,0,60737,60737
"343",52007,"Meeker, Town of",2011,2,0,43002,0,43002
"344",52007,"Meeker, Town of",2010,2,0,84002,23093,107095
"345",52007,"Meeker, Town of",2012,2,0,0,0,0
"346",52007,"Meeker, Town of",2013,2,0,0,0,0
"347",52007,"Meeker, Town of",2014,2,0,0,0,0
"348",50007,"Granada, Town of",2010,2,0,0,439716,439716
"349",50007,"Granada, Town of",2011,2,0,0,433300,433300
"350",50007,"Granada, Town of",2012,2,0,0,426562,426562
"351",50007,"Granada, Town of",2012,3,0,0,0,0
"352",50007,"Granada, Town of",2014,2,0,0,406577,406577
"353",50007,"Granada, Town of",2013,2,0,0,414977,414977
"354",50007,"Granada, Town of",2013,3,0,0,0,0
"355",50008,"Hartman, Town of",2011,2,0,87240,0,87240
"356",50008,"Hartman, Town of",2014,2,0,78604,0,78604
"357",50008,"Hartman, Town of",2010,2,0,88654,0,88654
"358",50008,"Hartman, Town of",2012,2,0,85826,0,85826
"359",50008,"Hartman, Town of",2013,2,0,84212,0,84212
"360",50011,"Holly, Town of",2010,2,0,0,0,0
"361",50011,"Holly, Town of",2010,3,0,0,0,0
"362",50011,"Holly, Town of",2011,2,0,0,0,0
"363",50011,"Holly, Town of",2011,3,0,0,0,0
"364",50011,"Holly, Town of",2014,2,0,0,0,0
"365",50011,"Holly, Town of",2014,3,0,0,0,0
"366",50011,"Holly, Town of",2012,2,0,0,0,0
"367",50011,"Holly, Town of",2012,3,0,0,0,0
"368",50011,"Holly, Town of",2013,2,0,0,0,0
"369",50011,"Holly, Town of",2013,3,0,0,0,0
"370",50012,"Lamar, City of",2010,1,0,1555000,6914465,8469465
"371",50012,"Lamar, City of",2011,1,0,1390000,6653386,8043386
"372",50012,"Lamar, City of",2014,1,0,870000,9400276,10270276
"373",50012,"Lamar, City of",2013,1,0,1045000,9302272,10347272
"374",50012,"Lamar, City of",2012,1,0,1220000,10782206,12002206
"375",50017,"Wiley, Town of",2012,2,0,0,444003,444003
"376",50017,"Wiley, Town of",2011,2,0,0,456367,456367
"377",50017,"Wiley, Town of",2010,2,0,0,468184,468184
"378",50017,"Wiley, Town of",2013,2,0,0,431064,431064
"379",50017,"Wiley, Town of",2014,2,0,0,409423,409423
"380",62022,"Greeley, City of",2011,3,0,0,2487994,2487994
"381",62022,"Greeley, City of",2011,2,0,68240000,7808513,76048513
"382",62022,"Greeley, City of",2012,3,0,0,2420011,2420011
"383",62022,"Greeley, City of",2012,2,0,93020000,6314530,99334530
"384",62022,"Greeley, City of",2010,3,0,0,4508861,4508861
"385",62022,"Greeley, City of",2010,2,750000,70195000,8687340,79632340
"386",62022,"Greeley, City of",2014,3,0,0,0,0
"387",62022,"Greeley, City of",2014,2,0,82645000,4685847,87330847
"388",62022,"Greeley, City of",2013,3,0,0,1198864,1198864
"389",62022,"Greeley, City of",2013,2,0,88330000,5513716,93843716
"390",61002,"Akron, Town of",2012,2,0,0,221086,221086
"391",61002,"Akron, Town of",2012,3,0,0,1720576,1720576
"392",61002,"Akron, Town of",2010,2,0,0,242530,242530
"393",61002,"Akron, Town of",2010,3,0,0,1764378,1764378
"394",61002,"Akron, Town of",2011,2,0,0,232005,232005
"395",61002,"Akron, Town of",2011,3,0,0,1742951,1742951
"396",61002,"Akron, Town of",2013,3,0,0,1697211,1697211
"397",61002,"Akron, Town of",2013,2,0,0,209757,209757
"398",61002,"Akron, Town of",2014,2,0,0,318302,318302
"399",61002,"Akron, Town of",2014,3,0,0,1672813,1672813
"400",61006,"Otis, Town of",2011,2,0,95000,0,95000
"401",61006,"Otis, Town of",2010,2,0,108000,0,108000
"402",61006,"Otis, Town of",2014,2,0,0,0,0
"403",61006,"Otis, Town of",2013,2,0,0,0,0
"404",61006,"Otis, Town of",2012,2,0,0,0,0
"405",60001,"Cripple Creek, City of",2011,1,0,843400,545090,1388490
"406",60001,"Cripple Creek, City of",2010,1,0,863700,589111,1452811
"407",60001,"Cripple Creek, City of",2012,1,0,821900,499500,1321400
"408",60001,"Cripple Creek, City of",2013,1,0,799200,489500,1288700
"409",60001,"Cripple Creek, City of",2014,1,0,775100,630248,1405348
"410",60012,"Victor, City of",2010,1,0,0,1394348,1394348
"411",60012,"Victor, City of",2011,1,0,0,1307991,1307991
"412",60012,"Victor, City of",2014,1,0,0,1061926,1061926
"413",60012,"Victor, City of",2013,1,0,0,1141005,1141005
"414",60012,"Victor, City of",2012,1,0,0,1219205,1219205
"415",59015,"Frisco, Town of",2010,2,0,0,0,0
"416",59015,"Frisco, Town of",2011,2,0,0,0,0
"417",59015,"Frisco, Town of",2013,2,0,0,0,0
"418",59015,"Frisco, Town of",2014,2,0,0,0,0
"419",59015,"Frisco, Town of",2012,2,0,0,0,0
"420",59018,"Silverthorne, Town of",2010,2,0,0,0,0
"421",59018,"Silverthorne, Town of",2010,3,0,0,0,0
"422",59018,"Silverthorne, Town of",2012,2,0,0,0,0
"423",59018,"Silverthorne, Town of",2012,3,0,0,0,0
"424",59018,"Silverthorne, Town of",2013,2,0,0,0,0
"425",59018,"Silverthorne, Town of",2013,3,0,0,0,0
"426",59018,"Silverthorne, Town of",2014,2,0,0,0,0
"427",59018,"Silverthorne, Town of",2014,3,0,0,0,0
"428",59018,"Silverthorne, Town of",2011,2,0,0,0,0
"429",59018,"Silverthorne, Town of",2011,3,0,0,0,0
"430",57027,"Mountain Village, Town of",2010,1,0,0,0,0
"431",57027,"Mountain Village, Town of",2011,1,0,0,0,0
"432",57027,"Mountain Village, Town of",2012,1,0,0,0,0
"433",57027,"Mountain Village, Town of",2013,1,0,0,0,0
"434",57027,"Mountain Village, Town of",2014,1,0,0,0,0
"435",58004,"Julesburg, Town of",2011,2,0,0,1067012,1067012
"436",58004,"Julesburg, Town of",2011,3,0,0,519300,519300
"437",58004,"Julesburg, Town of",2010,2,0,0,1126194,1126194
"438",58004,"Julesburg, Town of",2010,3,0,0,556234,556234
"439",58004,"Julesburg, Town of",2013,2,0,0,941679,941679
"440",58004,"Julesburg, Town of",2013,3,0,0,440896,440896
"441",58004,"Julesburg, Town of",2014,2,0,0,875531,875531
"442",58004,"Julesburg, Town of",2014,3,0,0,399303,399303
"443",58004,"Julesburg, Town of",2012,2,0,0,1007327,1007327
"444",58004,"Julesburg, Town of",2012,3,0,0,480874,480874
"445",58007,"Ovid, Town of",2010,2,0,0,85153,85153
"446",58007,"Ovid, Town of",2010,3,0,0,814,814
"447",58007,"Ovid, Town of",2011,2,0,0,81554,81554
"448",58007,"Ovid, Town of",2011,3,0,0,0,0
"449",58007,"Ovid, Town of",2014,2,0,0,69639,69639
"450",58007,"Ovid, Town of",2014,3,0,0,0,0
"451",58007,"Ovid, Town of",2013,2,0,0,73806,73806
"452",58007,"Ovid, Town of",2013,3,0,0,0,0
"453",58007,"Ovid, Town of",2012,2,0,0,77774,77774
"454",58007,"Ovid, Town of",2012,3,0,0,0,0
"455",58012,"Sedgwick, Town of",2010,1,0,0,356150,356150
"456",58012,"Sedgwick, Town of",2011,1,0,0,342183,342183
"457",58012,"Sedgwick, Town of",2013,1,0,0,314250,314250
"458",58012,"Sedgwick, Town of",2012,1,0,0,328217,328217
"459",58012,"Sedgwick, Town of",2014,1,0,0,300283,300283
"460",59004,"Breckenridge, Town of",2011,2,0,0,531112,531112
"461",59004,"Breckenridge, Town of",2010,2,0,0,568980,568980
"462",59004,"Breckenridge, Town of",2012,2,0,0,491730,491730
"463",59004,"Breckenridge, Town of",2014,2,0,0,412408,412408
"464",59004,"Breckenridge, Town of",2013,2,0,0,450773,450773
"465",59009,"Dillon, Town of",2011,2,0,0,1681728,1681728
"466",59009,"Dillon, Town of",2011,3,0,0,796442,796442
"467",59009,"Dillon, Town of",2010,2,0,0,1816273,1816273
"468",59009,"Dillon, Town of",2010,3,0,0,910514,910514
"469",59009,"Dillon, Town of",2012,2,0,0,1541756,1541756
"470",59009,"Dillon, Town of",2012,3,0,0,677412,677412
"471",59009,"Dillon, Town of",2014,2,0,0,1373352,1373352
"472",59009,"Dillon, Town of",2014,3,0,0,423605,423605
"473",59009,"Dillon, Town of",2013,2,0,0,1524093,1524093
"474",59009,"Dillon, Town of",2013,3,0,0,553208,553208
"475",57014,"Telluride, Town of",2010,2,10000000,0,0,1e+07
"476",57014,"Telluride, Town of",2010,3,96000,0,0,96000
"477",57014,"Telluride, Town of",2012,2,9220000,0,0,9220000
"478",57014,"Telluride, Town of",2012,3,0,0,0,0
"479",57014,"Telluride, Town of",2013,2,8805000,0,5395000,14200000
"480",57014,"Telluride, Town of",2013,3,0,0,0,0
"481",57014,"Telluride, Town of",2011,2,9625000,0,0,9625000
"482",57014,"Telluride, Town of",2011,3,0,0,0,0
"483",57014,"Telluride, Town of",2014,2,8385000,0,5221875,13606875
"484",57014,"Telluride, Town of",2014,3,0,0,0,0
"485",54023,"Steamboat Springs, City of",2010,1,0,0,5830785,5830785
"486",54023,"Steamboat Springs, City of",2011,1,0,0,17560792,17560792
"487",54023,"Steamboat Springs, City of",2014,1,0,0,14637817,14637817
"488",54023,"Steamboat Springs, City of",2013,1,0,0,15667115,15667115
"489",54023,"Steamboat Springs, City of",2012,1,0,0,16641241,16641241
"490",54030,"Yampa, Town of",2011,1,0,24000,0,24000
"491",54030,"Yampa, Town of",2010,1,0,35000,0,35000
"492",54030,"Yampa, Town of",2012,1,0,12000,0,12000
"493",54030,"Yampa, Town of",2014,1,0,0,0,0
"494",54030,"Yampa, Town of",2013,1,0,0,0,0
"495",55004,"Crestone, Town of",2010,2,0,0,124000,124000
"496",55004,"Crestone, Town of",2010,3,0,0,43179,43179
"497",55004,"Crestone, Town of",2012,2,0,0,114163,114163
"498",55004,"Crestone, Town of",2012,3,0,0,26662,26662
"499",55004,"Crestone, Town of",2011,2,0,0,119201,119201
"500",55004,"Crestone, Town of",2011,3,0,0,35122,35122
"501",55004,"Crestone, Town of",2014,1,0,0,103317,103317
"502",55004,"Crestone, Town of",2013,1,0,0,123652,123652
"503",55008,"Saguache, Town of",2010,1,0,0,0,0
"504",55008,"Saguache, Town of",2011,1,0,0,0,0
"505",55008,"Saguache, Town of",2012,1,0,0,0,0
"506",55008,"Saguache, Town of",2013,1,0,0,68649,68649
"507",55008,"Saguache, Town of",2014,1,0,0,62245,62245
"508",56002,"Silverton, Town of",2010,2,44000,0,163001,207001
"509",56002,"Silverton, Town of",2010,3,0,0,25849,25849
"510",56002,"Silverton, Town of",2012,2,21000,0,133365,154365
"511",56002,"Silverton, Town of",2012,3,0,0,28411,28411
"512",56002,"Silverton, Town of",2011,2,33000,0,160134,193134
"513",56002,"Silverton, Town of",2011,3,0,0,34775,34775
"514",56002,"Silverton, Town of",2014,2,0,0,91726,91726
"515",56002,"Silverton, Town of",2014,3,0,0,18975,18975
"516",56002,"Silverton, Town of",2013,2,9000,0,105845,114845
"517",56002,"Silverton, Town of",2013,3,0,0,22552,22552
"518",57007,"Norwood, Town of",2010,2,0,217124,823530,1040654
"519",57007,"Norwood, Town of",2012,2,0,144413,733288,877701
"520",57007,"Norwood, Town of",2013,2,0,112239,682550,794789
"521",57007,"Norwood, Town of",2014,2,0,76203,626828,703031
"522",57007,"Norwood, Town of",2011,2,0,182633,778129,960762
"523",64009,"Arvada, City of",2011,2,0,17025000,0,17025000
"524",64009,"Arvada, City of",2011,3,0,0,0,0
"525",64009,"Arvada, City of",2010,2,0,18655000,0,18655000
"526",64009,"Arvada, City of",2010,3,0,0,0,0
"527",64009,"Arvada, City of",2013,2,0,13614000,0,13614000
"528",64009,"Arvada, City of",2013,3,0,0,0,0
"529",64009,"Arvada, City of",2012,2,0,15345000,0,15345000
"530",64009,"Arvada, City of",2012,3,0,0,0,0
"531",64009,"Arvada, City of",2014,2,0,11854000,0,11854000
"532",64009,"Arvada, City of",2014,3,0,0,0,0
"533",64010,"Aurora, City of",2011,2,0,559220000,77809403,637029403
"534",64010,"Aurora, City of",2011,3,0,59231215,0,59231215
"535",64010,"Aurora, City of",2010,2,18410000,595040000,78396897,691846897
"536",64010,"Aurora, City of",2010,3,0,62142058,0,62142058
"537",64010,"Aurora, City of",2013,2,0,515100000,75059163,590159163
"538",64010,"Aurora, City of",2013,3,0,32295000,0,32295000
"539",64010,"Aurora, City of",2012,2,0,515100000,77221909,592321909
"540",64010,"Aurora, City of",2012,3,0,52330000,0,52330000
"541",64010,"Aurora, City of",2014,2,0,491145000,73247956,564392956
"542",64010,"Aurora, City of",2014,3,0,32295000,0,32295000
"543",64017,"Basalt, Town of",2010,2,0,0,767629,767629
"544",64017,"Basalt, Town of",2011,2,0,0,713361,713361
"545",64017,"Basalt, Town of",2012,2,0,0,656684,656684
"546",64017,"Basalt, Town of",2014,2,0,0,537913,537913
"547",64017,"Basalt, Town of",2013,2,0,0,608901,608901
"548",64039,"Center, Town of",2012,2,0,0,0,0
"549",64039,"Center, Town of",2010,2,0,0,0,0
"550",64039,"Center, Town of",2014,2,0,0,0,0
"551",64039,"Center, Town of",2013,2,0,0,0,0
"552",63003,"Eckley, Town of",2010,2,0,0,87500,87500
"553",63003,"Eckley, Town of",2010,3,67600,0,0,67600
"554",63003,"Eckley, Town of",2011,2,0,0,82500,82500
"555",63003,"Eckley, Town of",2011,3,62200,0,0,62200
"556",63003,"Eckley, Town of",2014,2,0,0,67500,67500
"557",63003,"Eckley, Town of",2014,3,44500,0,0,44500
"558",63003,"Eckley, Town of",2013,2,0,0,72500,72500
"559",63003,"Eckley, Town of",2013,3,50700,0,0,50700
"560",63003,"Eckley, Town of",2012,2,0,0,77500,77500
"561",63003,"Eckley, Town of",2012,3,56600,0,0,56600
"562",63010,"Wray, City of",2011,2,0,0,275562,275562
"563",63010,"Wray, City of",2011,3,0,0,0,0
"564",63010,"Wray, City of",2010,2,0,0,319208,319208
"565",63010,"Wray, City of",2010,3,0,21399,0,21399
"566",63010,"Wray, City of",2014,3,0,0,0,0
"567",63010,"Wray, City of",2014,2,0,0,0,0
"568",63010,"Wray, City of",2012,2,0,0,230089,230089
"569",63010,"Wray, City of",2012,3,0,0,0,0
"570",63010,"Wray, City of",2013,2,0,0,0,0
"571",63010,"Wray, City of",2013,3,0,0,0,0
"572",63017,"Yuma, City of",2010,2,0,0,0,0
"573",63017,"Yuma, City of",2010,3,0,0,0,0
"574",63017,"Yuma, City of",2011,2,0,0,0,0
"575",63017,"Yuma, City of",2011,3,0,0,0,0
"576",63017,"Yuma, City of",2014,2,0,0,0,0
"577",63017,"Yuma, City of",2014,3,0,0,0,0
"578",63017,"Yuma, City of",2012,2,0,0,0,0
"579",63017,"Yuma, City of",2012,3,0,0,0,0
"580",63017,"Yuma, City of",2013,2,0,0,0,0
"581",63017,"Yuma, City of",2013,3,0,0,0,0
"582",64258,"Bennett, Town of",2010,2,0,0,339542,339542
"583",64258,"Bennett, Town of",2010,3,0,0,237325,237325
"584",64258,"Bennett, Town of",2013,2,0,0,287669,287669
"585",64258,"Bennett, Town of",2013,3,0,0,203279,203279
"586",64258,"Bennett, Town of",2012,2,0,0,310736,310736
"587",64258,"Bennett, Town of",2012,3,0,0,215311,215311
"588",64258,"Bennett, Town of",2011,2,0,0,332786,332786
"589",64258,"Bennett, Town of",2011,3,0,0,226849,226849
"590",64258,"Bennett, Town of",2014,2,0,0,263534,263534
"591",64258,"Bennett, Town of",2014,3,0,0,190730,190730
"592",64263,"Central City",2011,2,1100000,0,0,1100000
"593",64263,"Central City",2010,2,1525000,0,0,1525000
"594",64263,"Central City",2013,2,0,0,0,0
"595",64263,"Central City",2012,2,680000,0,0,680000
"596",64263,"Central City",2014,2,0,0,0,0
"597",64264,"Thornton, City of",2010,2,40220000,4e+07,331035,80551035
"598",64264,"Thornton, City of",2010,3,0,1360000,0,1360000
"599",64264,"Thornton, City of",2011,2,32260000,4e+07,145787,72405787
"600",64264,"Thornton, City of",2011,3,0,1110000,0,1110000
"601",64264,"Thornton, City of",2012,2,24250000,40026427,113908,64390335
"602",64264,"Thornton, City of",2012,3,0,823573,0,823573
"603",64264,"Thornton, City of",2013,2,16175000,39380000,79160,55634160
"604",64264,"Thornton, City of",2013,3,0,575000,0,575000
"605",64264,"Thornton, City of",2014,2,8045000,39180000,41284,47266284
"606",64264,"Thornton, City of",2014,3,0,295000,0,295000
"607",64225,"Windsor, Town of",2010,2,0,0,0,0
"608",64225,"Windsor, Town of",2010,3,0,0,0,0
"609",64225,"Windsor, Town of",2011,2,0,0,0,0
"610",64225,"Windsor, Town of",2011,3,0,0,0,0
"611",64225,"Windsor, Town of",2013,2,0,0,0,0
"612",64225,"Windsor, Town of",2013,3,0,0,2753693,2753693
"613",64225,"Windsor, Town of",2012,2,0,0,0,0
"614",64225,"Windsor, Town of",2012,3,0,0,2932118,2932118
"615",64225,"Windsor, Town of",2014,2,0,0,8188848,8188848
"616",64225,"Windsor, Town of",2014,3,0,0,2575268,2575268
"617",64237,"Berthoud, Town of",2010,2,0,3890000,0,3890000
"618",64237,"Berthoud, Town of",2010,3,0,1985001,6855000,8840001
"619",64237,"Berthoud, Town of",2011,2,0,3625000,0,3625000
"620",64237,"Berthoud, Town of",2011,3,0,1880000,6540000,8420000
"621",64237,"Berthoud, Town of",2012,2,0,4460000,0,4460000
"622",64237,"Berthoud, Town of",2012,3,0,1715000,9445000,11160000
"623",64237,"Berthoud, Town of",2014,2,0,3880000,712461,4592461
"624",64237,"Berthoud, Town of",2014,3,0,1445000,9235000,10680000
"625",64237,"Berthoud, Town of",2013,2,0,4180000,750000,4930000
"626",64237,"Berthoud, Town of",2013,3,0,1580000,9345000,10925000
"627",64198,"Northglenn, City of",2012,1,0,0,13125649,13125649
"628",64198,"Northglenn, City of",2010,1,0,0,17215000,17215000
"629",64198,"Northglenn, City of",2011,1,0,0,15198339,15198339
"630",64198,"Northglenn, City of",2013,1,0,0,11163880,11163880
"631",64198,"Northglenn, City of",2014,1,0,0,8776023,8776023
"632",64205,"Longmont, City of",2011,2,0,0,13052113,13052113
"633",64205,"Longmont, City of",2011,3,0,13115000,158837,13273837
"634",64205,"Longmont, City of",2010,2,0,0,14014023,14014023
"635",64205,"Longmont, City of",2010,3,0,13390000,367416,13757416
"636",64205,"Longmont, City of",2012,2,0,0,12079147,12079147
"637",64205,"Longmont, City of",2012,3,0,12770000,0,12770000
"638",64205,"Longmont, City of",2013,2,0,0,11089597,11089597
"639",64205,"Longmont, City of",2013,3,0,19960000,0,19960000
"640",64205,"Longmont, City of",2014,2,0,0,10083462,10083462
"641",64205,"Longmont, City of",2014,3,0,19090000,0,19090000
"642",64153,"Westminster, City of",2010,1,0,37090000,28546205,65636205
"643",64153,"Westminster, City of",2011,1,0,35310000,26129755,61439755
"644",64153,"Westminster, City of",2012,1,0,33460000,23630210,57090210
"645",64153,"Westminster, City of",2013,1,0,31530000,20622014,52152014
"646",64153,"Westminster, City of",2014,1,0,29505000,17957768,47462768
"647",38016,"Peetz, Town of",2011,2,0,0,0,0
"648",38016,"Peetz, Town of",2011,3,0,0,0,0
"649",38016,"Peetz, Town of",2010,2,0,0,0,0
"650",38016,"Peetz, Town of",2010,3,0,0,0,0
"651",38016,"Peetz, Town of",2012,2,0,0,0,0
"652",38016,"Peetz, Town of",2012,3,0,0,0,0
"653",38016,"Peetz, Town of",2014,2,0,0,0,0
"654",38016,"Peetz, Town of",2014,3,0,0,0,0
"655",38016,"Peetz, Town of",2013,2,0,0,0,0
"656",38016,"Peetz, Town of",2013,3,0,0,0,0
"657",38019,"Sterling, City of",2010,2,0,0,4800000,4800000
"658",38019,"Sterling, City of",2010,3,0,0,963414,963414
"659",38019,"Sterling, City of",2011,2,0,0,28558845,28558845
"660",38019,"Sterling, City of",2011,3,0,0,818902,818902
"661",38019,"Sterling, City of",2014,2,0,0,26424212,26424212
"662",38019,"Sterling, City of",2014,3,0,0,353252,353252
"663",38019,"Sterling, City of",2012,2,0,0,28553086,28553086
"664",38019,"Sterling, City of",2012,3,0,0,669038,669038
"665",38019,"Sterling, City of",2013,2,0,0,27984197,27984197
"666",38019,"Sterling, City of",2013,3,0,0,513821,513821
"667",39011,"Collbran, Town of",2010,2,0,0,0,0
"668",39011,"Collbran, Town of",2010,3,0,0,0,0
"669",39011,"Collbran, Town of",2011,2,0,0,0,0
"670",39011,"Collbran, Town of",2011,3,0,0,0,0
"671",39011,"Collbran, Town of",2012,2,0,0,0,0
"672",39011,"Collbran, Town of",2012,3,0,0,0,0
"673",39011,"Collbran, Town of",2013,2,0,0,0,0
"674",39011,"Collbran, Town of",2013,3,0,0,0,0
"675",39011,"Collbran, Town of",2014,2,0,0,0,0
"676",39011,"Collbran, Town of",2014,3,0,0,0,0
"677",39014,"Fruita, City of",2010,3,0,0,21884997,21884997
"678",39014,"Fruita, City of",2011,3,0,0,21424788,21424788
"679",39014,"Fruita, City of",2012,3,0,0,20933065,20933065
"680",39014,"Fruita, City of",2013,3,0,0,20422003,20422003
"681",39014,"Fruita, City of",2014,3,0,0,19871375,19871375
"682",39020,"Grand Junction, City of",2010,2,0,0,6242873,6242873
"683",39020,"Grand Junction, City of",2011,2,0,0,5902362,5902362
"684",39020,"Grand Junction, City of",2014,2,0,0,4874437,4874437
"685",39020,"Grand Junction, City of",2012,2,0,0,5569053,5569053
"686",39020,"Grand Junction, City of",2013,2,0,0,5226444,5226444
"687",38011,"Merino, Town of",2011,2,0,0,0,0
"688",38011,"Merino, Town of",2011,3,0,0,0,0
"689",38011,"Merino, Town of",2010,2,0,0,0,0
"690",38011,"Merino, Town of",2010,3,0,0,0,0
"691",38011,"Merino, Town of",2013,2,0,0,109737,109737
"692",38011,"Merino, Town of",2013,3,0,0,0,0
"693",38011,"Merino, Town of",2014,2,0,0,106522,106522
"694",38011,"Merino, Town of",2014,3,0,0,0,0
"695",38011,"Merino, Town of",2012,2,0,0,0,0
"696",38011,"Merino, Town of",2012,3,0,0,0,0
"697",36002,"Branson, Town of",2011,2,0,0,197562,197562
"698",36002,"Branson, Town of",2010,2,0,0,200055,200055
"699",36002,"Branson, Town of",2012,2,0,0,194962,194962
"700",36002,"Branson, Town of",2014,2,0,0,189422,189422
"701",36002,"Branson, Town of",2013,2,0,0,192250,192250
"702",35004,"Estes Park, Town of",2012,2,0,0,4864367,4864367
"703",35004,"Estes Park, Town of",2014,2,0,0,4330819,4330819
"704",35004,"Estes Park, Town of",2011,2,0,0,5125464,5125464
"705",35004,"Estes Park, Town of",2010,2,0,0,5417774,5417774
"706",35004,"Estes Park, Town of",2013,2,0,0,4597593,4597593
"707",35009,"Fort Collins, City of",2011,2,0,20533347,0,20533347
"708",35009,"Fort Collins, City of",2011,3,0,36123842,0,36123842
"709",35009,"Fort Collins, City of",2010,2,0,23288229,0,23288229
"710",35009,"Fort Collins, City of",2010,3,0,39105552,0,39105552
"711",35009,"Fort Collins, City of",2014,2,0,12350888,0,12350888
"712",35009,"Fort Collins, City of",2014,3,0,28120000,0,28120000
"713",35009,"Fort Collins, City of",2012,2,0,17679148,0,17679148
"714",35009,"Fort Collins, City of",2012,3,0,33025168,0,33025168
"715",35009,"Fort Collins, City of",2013,2,0,15109924,0,15109924
"716",35009,"Fort Collins, City of",2013,3,0,29760000,0,29760000
"717",34005,"Bayfield, Town of",2010,2,0,0,303358,303358
"718",34005,"Bayfield, Town of",2010,3,0,0,4580000,4580000
"719",34005,"Bayfield, Town of",2012,2,0,0,238142,238142
"720",34005,"Bayfield, Town of",2012,3,0,0,4185000,4185000
"721",34005,"Bayfield, Town of",2011,2,0,0,271501,271501
"722",34005,"Bayfield, Town of",2011,3,0,0,4385000,4385000
"723",34005,"Bayfield, Town of",2013,2,0,0,203210,203210
"724",34005,"Bayfield, Town of",2013,3,0,0,3980000,3980000
"725",34005,"Bayfield, Town of",2014,2,0,0,166630,166630
"726",34005,"Bayfield, Town of",2014,3,0,0,4112395,4112395
"727",34008,"Durango, City of",2011,2,0,0,0,0
"728",34008,"Durango, City of",2011,3,0,0,0,0
"729",34008,"Durango, City of",2010,2,0,0,0,0
"730",34008,"Durango, City of",2010,3,0,0,0,0
"731",34008,"Durango, City of",2013,2,0,0,3978753,3978753
"732",34008,"Durango, City of",2013,3,0,0,0,0
"733",34008,"Durango, City of",2012,2,0,0,0,0
"734",34008,"Durango, City of",2012,3,0,0,0,0
"735",34008,"Durango, City of",2014,2,0,0,3809251,3809251
"736",34008,"Durango, City of",2014,3,0,0,0,0
"737",32001,"Bethune, Town of",2010,2,0,0,362248,362248
"738",32001,"Bethune, Town of",2010,3,0,0,0,0
"739",32001,"Bethune, Town of",2011,2,0,0,334402,334402
"740",32001,"Bethune, Town of",2011,3,0,0,0,0
"741",32001,"Bethune, Town of",2013,2,0,0,306536,306536
"742",32001,"Bethune, Town of",2013,3,0,0,0,0
"743",32001,"Bethune, Town of",2012,2,0,0,320469,320469
"744",32001,"Bethune, Town of",2012,3,0,0,0,0
"745",32001,"Bethune, Town of",2014,2,0,0,292603,292603
"746",32001,"Bethune, Town of",2014,3,0,0,0,0
"747",23008,"Glenwood Springs, City of",2010,1,0,31460100,2727920,34188020
"748",23008,"Glenwood Springs, City of",2011,1,0,0,32646940,32646940
"749",23008,"Glenwood Springs, City of",2012,1,0,0,31070388,31070388
"750",23008,"Glenwood Springs, City of",2014,1,0,0,28261053,28261053
"751",23008,"Glenwood Springs, City of",2013,1,0,0,29686944,29686944
"752",23012,"New Castle, Town of",2010,1,0,0,8453703,8453703
"753",23012,"New Castle, Town of",2011,1,0,0,8108674,8108674
"754",23012,"New Castle, Town of",2013,1,0,0,7398982,7398982
"755",23012,"New Castle, Town of",2014,1,0,0,7033089,7033089
"756",23012,"New Castle, Town of",2012,1,0,0,7757482,7757482
"757",23013,"Parachute, Town of",2010,3,0,0,9008,9008
"758",23013,"Parachute, Town of",2010,2,0,0,246603,246603
"759",23013,"Parachute, Town of",2011,2,0,0,325224,325224
"760",23013,"Parachute, Town of",2011,3,0,0,3126,3126
"761",23013,"Parachute, Town of",2012,2,0,0,308105,308105
"762",23013,"Parachute, Town of",2012,3,0,0,8688,8688
"763",23013,"Parachute, Town of",2014,2,0,0,260401,260401
"764",23013,"Parachute, Town of",2014,3,0,0,5947,5947
"765",23013,"Parachute, Town of",2013,2,0,0,283813,283813
"766",23013,"Parachute, Town of",2013,3,0,0,7087,7087
"767",23017,"Rifle, City of",2010,2,0,0,2122898,2122898
"768",23017,"Rifle, City of",2010,3,0,0,16726127,16726127
"769",23017,"Rifle, City of",2014,2,0,0,23822853,23822853
"770",23017,"Rifle, City of",2014,3,0,0,13608340,13608340
"771",23017,"Rifle, City of",2012,2,0,0,26674643,26674643
"772",23017,"Rifle, City of",2012,3,0,0,15775259,15775259
"773",23017,"Rifle, City of",2013,2,0,0,26338145,26338145
"774",23017,"Rifle, City of",2013,3,0,0,14948256,14948256
"775",23017,"Rifle, City of",2011,2,0,0,1876781,1876781
"776",23017,"Rifle, City of",2011,3,0,0,15987647,15987647
"777",23019,"Silt, Town of",2010,1,0,3795000,1693283,5488283
"778",23019,"Silt, Town of",2012,1,0,5325000,57079,5382079
"779",23019,"Silt, Town of",2013,1,0,5050000,48265,5098265
"780",23019,"Silt, Town of",2014,1,0,4775000,61282,4836282
"781",23019,"Silt, Town of",2011,1,0,5575000,77967,5652967
"782",32015,"Seibert, Town of",2011,2,0,0,41711,41711
"783",32015,"Seibert, Town of",2011,3,0,0,138750,138750
"784",32015,"Seibert, Town of",2012,2,0,0,34162,34162
"785",32015,"Seibert, Town of",2012,3,0,0,131250,131250
"786",32015,"Seibert, Town of",2010,2,0,0,48900,48900
"787",32015,"Seibert, Town of",2010,3,0,30000,146250,176250
"788",32015,"Seibert, Town of",2013,2,0,0,26236,26236
"789",32015,"Seibert, Town of",2013,3,0,0,123750,123750
"790",32015,"Seibert, Town of",2014,2,0,0,17914,17914
"791",32015,"Seibert, Town of",2014,3,0,0,116250,116250
"792",32020,"Stratton, Town of",2012,2,0,0,630565,630565
"793",32020,"Stratton, Town of",2012,3,0,0,389694,389694
"794",32020,"Stratton, Town of",2010,3,0,0,433984,433984
"795",32020,"Stratton, Town of",2010,2,0,0,676738,676738
"796",32020,"Stratton, Town of",2011,2,0,0,675990,675990
"797",32020,"Stratton, Town of",2011,3,0,0,412079,412079
"798",32020,"Stratton, Town of",2014,3,0,0,343429,343429
"799",32020,"Stratton, Town of",2014,2,0,0,1459211,1459211
"800",32020,"Stratton, Town of",2013,2,0,0,1504266,1504266
"801",32020,"Stratton, Town of",2013,3,0,0,366815,366815
"802",31002,"Eads, Town of",2011,3,0,0,160080,160080
"803",31002,"Eads, Town of",2011,2,0,0,1009838,1009838
"804",31002,"Eads, Town of",2010,3,0,0,170811,170811
"805",31002,"Eads, Town of",2010,2,0,0,1024921,1024921
"806",31002,"Eads, Town of",2014,3,0,0,124558,124558
"807",31002,"Eads, Town of",2014,2,0,0,960098,960098
"808",31002,"Eads, Town of",2012,3,0,0,148812,148812
"809",31002,"Eads, Town of",2012,2,0,0,994030,994030
"810",31002,"Eads, Town of",2013,3,0,0,136981,136981
"811",31002,"Eads, Town of",2013,2,0,0,977462,977462
"812",30065,"Morrison, Town of",2010,1,0,0,835630,835630
"813",30065,"Morrison, Town of",2011,1,0,0,788992,788992
"814",30065,"Morrison, Town of",2012,1,0,0,740211,740211
"815",30065,"Morrison, Town of",2013,1,0,0,332156,332156
"816",30065,"Morrison, Town of",2014,1,0,0,301664,301664
"817",30067,"Mountain View, Town of",2010,3,0,0,0,0
"818",30067,"Mountain View, Town of",2011,3,0,0,0,0
"819",30067,"Mountain View, Town of",2012,3,0,0,0,0
"820",30067,"Mountain View, Town of",2013,3,0,0,0,0
"821",30067,"Mountain View, Town of",2014,3,0,0,0,0
"822",30055,"Lakewood, City of",2011,3,0,0,0,0
"823",30055,"Lakewood, City of",2011,2,0,0,0,0
"824",30055,"Lakewood, City of",2010,2,0,0,0,0
"825",30055,"Lakewood, City of",2010,3,0,0,0,0
"826",30055,"Lakewood, City of",2014,3,0,0,0,0
"827",30055,"Lakewood, City of",2014,2,0,0,0,0
"828",30055,"Lakewood, City of",2013,3,0,0,0,0
"829",30055,"Lakewood, City of",2013,2,0,0,0,0
"830",30055,"Lakewood, City of",2012,3,0,0,0,0
"831",30055,"Lakewood, City of",2012,2,0,0,0,0
"832",53002,"Del Norte, Town of",2012,2,0,0,597889,597889
"833",53002,"Del Norte, Town of",2012,3,0,0,130452,130452
"834",53002,"Del Norte, Town of",2010,2,0,0,683378,683378
"835",53002,"Del Norte, Town of",2010,3,0,0,144146,144146
"836",53002,"Del Norte, Town of",2011,2,0,0,634125,634125
"837",53002,"Del Norte, Town of",2011,3,0,0,137466,137466
"838",53002,"Del Norte, Town of",2014,2,0,0,525417,525417
"839",53002,"Del Norte, Town of",2014,3,0,0,115354,115354
"840",53002,"Del Norte, Town of",2013,2,0,0,561653,561653
"841",53002,"Del Norte, Town of",2013,3,0,0,123087,123087
"842",54010,"Oak Creek, Town of",2010,2,0,0,658156,658156
"843",54010,"Oak Creek, Town of",2010,3,0,0,1208000,1208000
"844",54010,"Oak Creek, Town of",2011,2,0,0,618671,618671
"845",54010,"Oak Creek, Town of",2011,3,0,0,1195388,1195388
"846",54010,"Oak Creek, Town of",2013,2,0,0,534853,534853
"847",54010,"Oak Creek, Town of",2013,3,0,0,1166334,1166334
"848",54010,"Oak Creek, Town of",2014,2,0,0,490386,490386
"849",54010,"Oak Creek, Town of",2014,3,0,0,1152039,1152039
"850",54010,"Oak Creek, Town of",2012,2,0,0,577592,577592
"851",54010,"Oak Creek, Town of",2012,3,0,0,1180074,1180074
"852",51005,"Boone, Town of",2010,1,0,0,548742,548742
"853",51005,"Boone, Town of",2011,1,0,0,719956,719956
"854",51005,"Boone, Town of",2013,1,0,0,685448,685448
"855",51005,"Boone, Town of",2012,1,0,0,719956,719956
"856",51005,"Boone, Town of",2014,1,0,0,650941,650941
"857",51016,"Pueblo, City of",2012,2,0,49895000,7074044,56969044
"858",51016,"Pueblo, City of",2012,3,0,0,28066409,28066409
"859",51016,"Pueblo, City of",2011,2,0,51425185,7368572,58793757
"860",51016,"Pueblo, City of",2011,3,0,0,29493986,29493986
"861",51016,"Pueblo, City of",2010,2,0,53400711,9560355,62961066
"862",51016,"Pueblo, City of",2010,3,0,0,30915980,30915980
"863",51016,"Pueblo, City of",2013,2,0,47695000,6768805,54463805
"864",51016,"Pueblo, City of",2013,3,0,0,26606588,26606588
"865",51016,"Pueblo, City of",2014,2,0,45380000,6447501,51827501
"866",51016,"Pueblo, City of",2014,3,0,0,29297574,29297574
"867",51018,"Rye, Town of",2010,2,0,0,533275,533275
"868",51018,"Rye, Town of",2010,3,0,0,0,0
"869",51018,"Rye, Town of",2011,2,0,0,508225,508225
"870",51018,"Rye, Town of",2011,3,0,0,0,0
"871",51018,"Rye, Town of",2014,2,0,0,456527,456527
"872",51018,"Rye, Town of",2014,3,0,0,0,0
"873",51018,"Rye, Town of",2013,2,0,0,479564,479564
"874",51018,"Rye, Town of",2013,3,0,0,0,0
"875",51018,"Rye, Town of",2012,2,0,0,494020,494020
"876",51018,"Rye, Town of",2012,3,0,0,0,0
"877",36004,"Cokedale, Town of",2012,1,0,0,129966,129966
"878",36004,"Cokedale, Town of",2010,1,0,0,142297,142297
"879",36004,"Cokedale, Town of",2011,1,0,0,136282,136282
"880",36004,"Cokedale, Town of",2013,1,0,0,123334,123334
"881",36004,"Cokedale, Town of",2014,1,0,0,279853,279853
"882",36011,"Trinidad, City of",2010,2,0,0,50719,50719
"883",36011,"Trinidad, City of",2010,3,0,0,3220623,3220623
"884",36011,"Trinidad, City of",2012,2,0,0,0,0
"885",36011,"Trinidad, City of",2012,3,0,0,2504929,2504929
"886",36011,"Trinidad, City of",2011,2,0,0,25857,25857
"887",36011,"Trinidad, City of",2011,3,0,0,2868117,2868117
"888",36011,"Trinidad, City of",2014,2,0,0,0,0
"889",36011,"Trinidad, City of",2014,3,0,0,1735825,1735825
"890",36011,"Trinidad, City of",2013,2,0,0,0,0
"891",36011,"Trinidad, City of",2013,3,0,0,2125718,2125718
"892",37002,"Arriba, Town of",2010,2,0,0,488167,488167
"893",37002,"Arriba, Town of",2010,3,0,11000,24784,35784
"894",37002,"Arriba, Town of",2011,2,0,0,471333,471333
"895",37002,"Arriba, Town of",2011,3,0,6000,22814,28814
"896",37002,"Arriba, Town of",2012,2,0,0,454500,454500
"897",37002,"Arriba, Town of",2012,3,0,0,20745,20745
"898",37002,"Arriba, Town of",2013,2,0,0,437667,437667
"899",37002,"Arriba, Town of",2013,3,0,0,18573,18573
"900",37002,"Arriba, Town of",2014,2,0,0,420833,420833
"901",37002,"Arriba, Town of",2014,3,0,0,16291,16291
"902",37006,"Hugo, Town of",2010,2,0,0,0,0
"903",37006,"Hugo, Town of",2010,3,0,0,0,0
"904",37006,"Hugo, Town of",2011,2,0,0,0,0
"905",37006,"Hugo, Town of",2011,3,0,0,0,0
"906",37006,"Hugo, Town of",2014,2,0,0,0,0
"907",37006,"Hugo, Town of",2014,3,0,0,0,0
"908",37006,"Hugo, Town of",2013,2,0,0,0,0
"909",37006,"Hugo, Town of",2013,3,0,0,0,0
"910",37006,"Hugo, Town of",2012,2,0,0,0,0
"911",37006,"Hugo, Town of",2012,3,0,0,0,0
"912",37007,"Limon, Town of",2010,1,315000,2754153,276710,3345863
"913",37007,"Limon, Town of",2011,1,270000,2601737,252565,3124302
"914",37007,"Limon, Town of",2012,1,0,3622905,0,3622905
"915",37007,"Limon, Town of",2014,1,0,3176241,333746,3509987
"916",37007,"Limon, Town of",2013,1,0,3400284,395197,3795481
"917",38002,"Crook, Town of",2012,2,0,0,11266,11266
"918",38002,"Crook, Town of",2012,3,0,0,0,0
"919",38002,"Crook, Town of",2011,2,0,0,0,0
"920",38002,"Crook, Town of",2011,3,0,0,0,0
"921",38002,"Crook, Town of",2010,2,0,0,0,0
"922",38002,"Crook, Town of",2010,3,0,0,0,0
"923",38002,"Crook, Town of",2013,2,0,0,11266,11266
"924",38002,"Crook, Town of",2013,3,0,0,0,0
"925",38002,"Crook, Town of",2014,2,0,0,0,0
"926",38002,"Crook, Town of",2014,3,0,0,0,0
"927",38007,"Iliff, Town of",2010,2,0,0,2984,2984
"928",38007,"Iliff, Town of",2010,3,0,0,22500,22500
"929",38007,"Iliff, Town of",2011,2,0,0,1528,1528
"930",38007,"Iliff, Town of",2011,3,0,0,20000,20000
"931",38007,"Iliff, Town of",2012,2,0,0,0,0
"932",38007,"Iliff, Town of",2012,3,0,0,0,0
"933",38007,"Iliff, Town of",2013,2,0,0,0,0
"934",38007,"Iliff, Town of",2013,3,0,0,0,0
"935",38007,"Iliff, Town of",2014,2,0,0,0,0
"936",38007,"Iliff, Town of",2014,3,0,0,0,0
"937",48005,"Holyoke, City of",2013,1,0,0,0,0
"938",48005,"Holyoke, City of",2014,1,0,0,0,0
"939",48006,"Paoli, Town of",2010,1,0,0,0,0
"940",48006,"Paoli, Town of",2013,1,0,0,0,0
"941",48006,"Paoli, Town of",2012,1,0,0,0,0
"942",48006,"Paoli, Town of",2014,1,0,0,0,0
"943",49006,"Aspen, City of",2010,2,0,0,0,0
"944",49006,"Aspen, City of",2011,2,0,0,0,0
"945",49006,"Aspen, City of",2014,2,0,0,0,0
"946",49006,"Aspen, City of",2013,2,0,0,0,0
"947",49006,"Aspen, City of",2012,2,0,0,0,0
"948",47001,"Alma, Town of",2011,3,0,0,103497,103497
"949",47001,"Alma, Town of",2011,2,0,0,766587,766587
"950",47001,"Alma, Town of",2010,2,0,0,156352,156352
"951",47001,"Alma, Town of",2010,3,0,0,106248,106248
"952",47001,"Alma, Town of",2012,2,0,0,736219,736219
"953",47001,"Alma, Town of",2012,3,0,0,100723,100723
"954",47001,"Alma, Town of",2013,2,0,0,705287,705287
"955",47001,"Alma, Town of",2013,3,0,0,97589,97589
"956",47001,"Alma, Town of",2014,2,0,0,492664,492664
"957",47001,"Alma, Town of",2014,3,0,0,94392,94392
"958",47005,"Fairplay, Town of",2012,2,0,82700,188080,270780
"959",47005,"Fairplay, Town of",2010,2,95000,85300,329254,509554
"960",47005,"Fairplay, Town of",2011,2,0,83700,260704,344404
"961",47005,"Fairplay, Town of",2014,2,0,79200,73246,152446
"962",47005,"Fairplay, Town of",2013,2,0,81000,115409,196409
"963",45007,"La Junta, City of",2011,2,0,0,7951703,7951703
"964",45007,"La Junta, City of",2011,3,0,0,192036,192036
"965",45007,"La Junta, City of",2012,2,0,0,7371222,7371222
"966",45007,"La Junta, City of",2012,3,0,0,173028,173028
"967",45007,"La Junta, City of",2010,2,0,0,8521317,8521317
"968",45007,"La Junta, City of",2010,3,0,0,210216,210216
"969",45007,"La Junta, City of",2013,2,0,0,6779874,6779874
"970",45007,"La Junta, City of",2013,3,0,0,153155,153155
"971",45007,"La Junta, City of",2014,2,0,0,6172228,6172228
"972",45007,"La Junta, City of",2014,3,0,0,132377,132377
"973",45014,"Rocky Ford, City of",2010,2,394000,2822415,120000,3336415
"974",45014,"Rocky Ford, City of",2010,3,0,0,101464,101464
"975",45014,"Rocky Ford, City of",2014,2,214000,2617488,1240280,4071768
"976",45014,"Rocky Ford, City of",2014,3,0,0,2288556,2288556
"977",45014,"Rocky Ford, City of",2011,2,354000,2783153,106800,3243953
"978",45014,"Rocky Ford, City of",2011,3,0,0,97857,97857
"979",45014,"Rocky Ford, City of",2013,2,264000,2698746,1300039,4262785
"980",45014,"Rocky Ford, City of",2013,3,0,0,1608718,1608718
"981",45014,"Rocky Ford, City of",2012,2,309000,2750381,1371854,4431235
"982",45014,"Rocky Ford, City of",2012,3,0,0,1651634,1651634
"983",45015,"Swink, Town of",2010,2,0,0,850161,850161
"984",45015,"Swink, Town of",2010,3,0,0,0,0
"985",45015,"Swink, Town of",2011,2,0,0,820349,820349
"986",45015,"Swink, Town of",2011,3,0,0,51814,51814
"987",45015,"Swink, Town of",2013,2,0,0,739144,739144
"988",45015,"Swink, Town of",2013,3,0,0,26454,26454
"989",45015,"Swink, Town of",2014,2,0,0,695879,695879
"990",45015,"Swink, Town of",2014,3,0,0,13367,13367
"991",45015,"Swink, Town of",2012,2,0,0,781179,781179
"992",45015,"Swink, Town of",2012,3,0,0,39268,39268
"993",46007,"Ouray, City of",2011,1,0,0,789485,789485
"994",46007,"Ouray, City of",2010,1,0,0,924448,924448
"995",46007,"Ouray, City of",2012,1,0,0,694104,694104
"996",46007,"Ouray, City of",2014,1,0,0,385864,385864
"997",46007,"Ouray, City of",2013,1,0,0,461071,461071
"998",46009,"Ridgway, Town of",2011,2,100000,0,550828,650828
"999",46009,"Ridgway, Town of",2011,3,0,0,179424,179424
"1000",46009,"Ridgway, Town of",2010,2,110000,0,588856,698856
"1001",46009,"Ridgway, Town of",2010,3,0,0,222421,222421
"1002",46009,"Ridgway, Town of",2013,2,78000,0,481722,559722
"1003",46009,"Ridgway, Town of",2013,3,0,0,165190,165190
"1004",46009,"Ridgway, Town of",2014,2,66000,0,446437,512437
"1005",46009,"Ridgway, Town of",2014,3,0,0,157534,157534
"1006",46009,"Ridgway, Town of",2012,2,89000,0,516513,605513
"1007",46009,"Ridgway, Town of",2012,3,0,0,172480,172480
"1008",44006,"Fort Morgan, City of",2010,2,0,5876000,18692702,24568702
"1009",44006,"Fort Morgan, City of",2010,3,0,0,3018778,3018778
"1010",44006,"Fort Morgan, City of",2011,2,0,5771000,17410958,23181958
"1011",44006,"Fort Morgan, City of",2011,3,0,0,2466044,2466044
"1012",44006,"Fort Morgan, City of",2014,2,0,5426000,13298663,18724663
"1013",44006,"Fort Morgan, City of",2014,3,0,0,785217,785217
"1014",44006,"Fort Morgan, City of",2013,2,0,5547000,14516964,20063964
"1015",44006,"Fort Morgan, City of",2013,3,0,0,1459075,1459075
"1016",44006,"Fort Morgan, City of",2012,2,0,5662000,15699216,21361216
"1017",44006,"Fort Morgan, City of",2012,3,0,0,2104401,2104401
"1018",44009,"Log Lane Village, Town of",2010,2,0,0,1948962,1948962
"1019",44009,"Log Lane Village, Town of",2010,3,0,0,93124,93124
"1020",44009,"Log Lane Village, Town of",2011,2,0,0,1903624,1903624
"1021",44009,"Log Lane Village, Town of",2011,3,0,0,78287,78287
"1022",44009,"Log Lane Village, Town of",2013,2,0,0,1808967,1808967
"1023",44009,"Log Lane Village, Town of",2013,3,0,0,46251,46251
"1024",44009,"Log Lane Village, Town of",2014,2,0,0,1759562,1759562
"1025",44009,"Log Lane Village, Town of",2014,3,0,0,29125,29125
"1026",44009,"Log Lane Village, Town of",2012,2,0,0,1856970,1856970
"1027",44009,"Log Lane Village, Town of",2012,3,0,0,62627,62627
"1028",44016,"Wiggins, Town of",2010,2,0,0,471711,471711
"1029",44016,"Wiggins, Town of",2010,3,0,0,42829,42829
"1030",44016,"Wiggins, Town of",2011,2,0,0,3783382,3783382
"1031",44016,"Wiggins, Town of",2011,3,0,0,35336,35336
"1032",44016,"Wiggins, Town of",2014,2,0,0,4085659,4085659
"1033",44016,"Wiggins, Town of",2014,3,0,0,10534,10534
"1034",44016,"Wiggins, Town of",2012,2,0,0,3691355,3691355
"1035",44016,"Wiggins, Town of",2012,3,0,0,27469,27469
"1036",44016,"Wiggins, Town of",2013,2,0,0,4380526,4380526
"1037",44016,"Wiggins, Town of",2013,3,0,0,19208,19208
"1038",45004,"Fowler, Town of",2010,3,0,0,332540,332540
"1039",45004,"Fowler, Town of",2010,2,0,0,12000,12000
"1040",45004,"Fowler, Town of",2011,3,0,0,300731,300731
"1041",45004,"Fowler, Town of",2011,2,0,0,12000,12000
"1042",45004,"Fowler, Town of",2012,3,0,0,267024,267024
"1043",45004,"Fowler, Town of",2012,2,0,0,12000,12000
"1044",45004,"Fowler, Town of",2014,3,0,0,1595199,1595199
"1045",45004,"Fowler, Town of",2014,2,0,0,141575,141575
"1046",45004,"Fowler, Town of",2013,3,0,0,233199,233199
"1047",45004,"Fowler, Town of",2013,2,0,0,149737,149737
"1048",43004,"Montrose, City of",2010,2,0,2796674,0,2796674
"1049",43004,"Montrose, City of",2010,3,0,2845900,0,2845900
"1050",43004,"Montrose, City of",2011,2,0,2376000,0,2376000
"1051",43004,"Montrose, City of",2011,3,0,1944000,0,1944000
"1052",43004,"Montrose, City of",2012,2,0,2235750,0,2235750
"1053",43004,"Montrose, City of",2012,3,0,1829250,0,1829250
"1054",43004,"Montrose, City of",2013,2,0,2092750,0,2092750
"1055",43004,"Montrose, City of",2013,3,0,1712250,0,1712250
"1056",43004,"Montrose, City of",2014,2,0,1941500,0,1941500
"1057",43004,"Montrose, City of",2014,3,0,1588500,0,1588500
"1058",43007,"Nucla, Town of",2010,2,0,163000,0,163000
"1059",43007,"Nucla, Town of",2010,3,0,0,0,0
"1060",43007,"Nucla, Town of",2011,2,0,143000,0,143000
"1061",43007,"Nucla, Town of",2011,3,0,0,0,0
"1062",43007,"Nucla, Town of",2014,2,0,0,93750,93750
"1063",43007,"Nucla, Town of",2014,3,0,0,0,0
"1064",43007,"Nucla, Town of",2012,2,0,122000,0,122000
"1065",43007,"Nucla, Town of",2012,3,0,0,0,0
"1066",43007,"Nucla, Town of",2013,2,0,1e+05,0,1e+05
"1067",43007,"Nucla, Town of",2013,3,0,0,0,0
"1068",43012,"Olathe, Town of",2010,2,0,0,6243,6243
"1069",43012,"Olathe, Town of",2010,3,0,1474531,6243,1480774
"1070",43012,"Olathe, Town of",2013,2,0,0,0,0
"1071",43012,"Olathe, Town of",2013,3,0,1413618,0,1413618
"1072",43012,"Olathe, Town of",2011,2,0,0,1314,1314
"1073",43012,"Olathe, Town of",2011,3,0,1455122,1314,1456436
"1074",43012,"Olathe, Town of",2012,2,0,0,0,0
"1075",43012,"Olathe, Town of",2012,3,0,1434833,0,1434833
"1076",43012,"Olathe, Town of",2014,2,0,0,0,0
"1077",43012,"Olathe, Town of",2014,3,0,1391435,0,1391435
"1078",44001,"Brush, City of",2010,2,0,0,244000,244000
"1079",44001,"Brush, City of",2010,3,0,0,9465000,9465000
"1080",44001,"Brush, City of",2011,2,0,0,112838,112838
"1081",44001,"Brush, City of",2011,3,0,0,9460000,9460000
"1082",44001,"Brush, City of",2014,2,0,0,0,0
"1083",44001,"Brush, City of",2014,3,0,0,8255000,8255000
"1084",44001,"Brush, City of",2012,2,0,0,18000,18000
"1085",44001,"Brush, City of",2012,3,0,0,9065000,9065000
"1086",44001,"Brush, City of",2013,2,0,0,0,0
"1087",44001,"Brush, City of",2013,3,0,0,8665000,8665000
"1088",42008,"Dolores, Town of",2011,2,0,0,98922,98922
"1089",42008,"Dolores, Town of",2011,3,0,0,62522,62522
"1090",42008,"Dolores, Town of",2012,2,0,0,85686,85686
"1091",42008,"Dolores, Town of",2012,3,0,0,45763,45763
"1092",42008,"Dolores, Town of",2010,2,0,0,111530,111530
"1093",42008,"Dolores, Town of",2010,3,0,0,78477,78477
"1094",42008,"Dolores, Town of",2014,2,0,0,57193,57193
"1095",42008,"Dolores, Town of",2014,3,0,0,22969,22969
"1096",42008,"Dolores, Town of",2013,2,0,0,71787,71787
"1097",42008,"Dolores, Town of",2013,3,0,0,34644,34644
"1098",42016,"Mancos, Town of",2011,2,72000,0,0,72000
"1099",42016,"Mancos, Town of",2011,3,0,76990,851753,928743
"1100",42016,"Mancos, Town of",2010,2,81000,0,9178,90178
"1101",42016,"Mancos, Town of",2010,3,0,81990,89103,171093
"1102",42016,"Mancos, Town of",2013,2,54000,0,0,54000
"1103",42016,"Mancos, Town of",2013,3,0,64991,852644,917635
"1104",42016,"Mancos, Town of",2014,2,45000,491000,0,536000
"1105",42016,"Mancos, Town of",2014,3,0,57491,799719,857210
"1106",42016,"Mancos, Town of",2012,2,63000,0,0,63000
"1107",42016,"Mancos, Town of",2012,3,0,71491,898199,969690
"1108",40001,"Creede, City of",2011,1,0,0,1237920,1237920
"1109",40001,"Creede, City of",2010,1,0,0,347465,347465
"1110",40001,"Creede, City of",2012,1,0,0,1176068,1176068
"1111",40001,"Creede, City of",2014,1,0,0,1102621,1102621
"1112",40001,"Creede, City of",2013,1,0,0,1139709,1139709
"1113",41005,"Dinosaur, Town of",2011,2,0,0,81756,81756
"1114",41005,"Dinosaur, Town of",2011,3,0,0,0,0
"1115",41005,"Dinosaur, Town of",2012,2,0,0,69343,69343
"1116",41005,"Dinosaur, Town of",2012,3,0,0,0,0
"1117",41005,"Dinosaur, Town of",2010,2,0,0,93577,93577
"1118",41005,"Dinosaur, Town of",2010,3,0,0,0,0
"1119",41005,"Dinosaur, Town of",2013,2,0,0,64986,64986
"1120",41005,"Dinosaur, Town of",2013,3,0,0,0,0
"1121",41005,"Dinosaur, Town of",2014,2,0,0,60412,60412
"1122",41005,"Dinosaur, Town of",2014,3,0,0,0,0
"1123",39034,"Palisade, Town of",2010,2,0,0,6214248,6214248
"1124",39034,"Palisade, Town of",2010,3,0,0,0,0
"1125",39034,"Palisade, Town of",2012,2,0,0,5884573,5884573
"1126",39034,"Palisade, Town of",2012,3,0,0,0,0
"1127",39034,"Palisade, Town of",2011,2,0,0,5960688,5960688
"1128",39034,"Palisade, Town of",2011,3,0,0,0,0
"1129",39034,"Palisade, Town of",2013,2,0,0,5896351,5896351
"1130",39034,"Palisade, Town of",2013,3,0,0,0,0
"1131",39034,"Palisade, Town of",2014,2,0,995000,4680990,5675990
"1132",39034,"Palisade, Town of",2014,3,0,0,0,0
"1133",21026,"Fountain, City of",2010,2,0,0,17953312,17953312
"1134",21026,"Fountain, City of",2011,2,0,0,26807815,26807815
"1135",21026,"Fountain, City of",2012,2,0,0,29298793,29298793
"1136",21026,"Fountain, City of",2013,2,0,0,37215993,37215993
"1137",21026,"Fountain, City of",2014,2,0,0,47237735,47237735
"1138",21032,"Monument, Town of",2010,2,253100,0,1716896,1969996
"1139",21032,"Monument, Town of",2011,2,219000,0,1497034,1716034
"1140",21032,"Monument, Town of",2012,2,182800,0,0,182800
"1141",21032,"Monument, Town of",2014,2,105000,0,794464,899464
"1142",21032,"Monument, Town of",2013,2,145000,0,1077353,1222353
"1143",21034,"Palmer Lake, Town of",2011,2,560000,0,1765348,2325348
"1144",21034,"Palmer Lake, Town of",2013,2,295000,0,1468641,1763641
"1145",21034,"Palmer Lake, Town of",2010,2,685000,0,1843502,2528502
"1146",21034,"Palmer Lake, Town of",2014,2,150000,0,1392673,1542673
"1147",21034,"Palmer Lake, Town of",2012,2,430000,0,1685623,2115623
"1148",20004,"Elizabeth, Town of",2012,1,0,0,5289773,5289773
"1149",20004,"Elizabeth, Town of",2010,1,0,0,5850235,5850235
"1150",20004,"Elizabeth, Town of",2011,1,0,0,5571473,5571473
"1151",20004,"Elizabeth, Town of",2014,1,0,0,4700714,4700714
"1152",20004,"Elizabeth, Town of",2013,1,0,0,4999562,4999562
"1153",20006,"Simla, Town of",2012,2,0,110500,9311,119811
"1154",20006,"Simla, Town of",2012,3,0,0,0,0
"1155",20006,"Simla, Town of",2010,2,0,158900,26410,185310
"1156",20006,"Simla, Town of",2010,3,0,0,0,0
"1157",20006,"Simla, Town of",2013,2,0,0,0,0
"1158",20006,"Simla, Town of",2013,3,0,0,113100,113100
"1159",20006,"Simla, Town of",2014,2,0,0,0,0
"1160",20006,"Simla, Town of",2014,3,0,0,101500,101500
"1161",20006,"Simla, Town of",2011,2,0,135200,18103,153303
"1162",20006,"Simla, Town of",2011,3,0,0,0,0
"1163",19024,"Minturn, Town of",2011,1,0,0,588280,588280
"1164",19024,"Minturn, Town of",2010,1,0,0,669190,669190
"1165",19024,"Minturn, Town of",2013,2,0,0,495495,495495
"1166",19024,"Minturn, Town of",2014,1,0,0,448668,448668
"1167",19024,"Minturn, Town of",2012,1,0,0,540489,540489
"1168",18021,"Larkspur, Town of",2011,1,0,0,101035,101035
"1169",18021,"Larkspur, Town of",2012,1,0,0,94577,94577
"1170",18021,"Larkspur, Town of",2010,2,0,0,107303,107303
"1171",18021,"Larkspur, Town of",2010,3,0,0,0,0
"1172",18021,"Larkspur, Town of",2013,1,0,0,87923,87923
"1173",18021,"Larkspur, Town of",2014,1,0,0,2081038,2081038
"1174",17003,"Dove Creek, Town of",2010,2,53000,0,97082,150082
"1175",17003,"Dove Creek, Town of",2010,3,0,0,0,0
"1176",17003,"Dove Creek, Town of",2011,2,47000,0,86509,133509
"1177",17003,"Dove Creek, Town of",2011,3,0,0,0,0
"1178",17003,"Dove Creek, Town of",2014,2,0,0,0,0
"1179",17003,"Dove Creek, Town of",2014,3,0,0,0,0
"1180",17003,"Dove Creek, Town of",2012,2,41000,0,75883,116883
"1181",17003,"Dove Creek, Town of",2012,3,0,0,0,0
"1182",17003,"Dove Creek, Town of",2013,2,34000,0,65204,99204
"1183",17003,"Dove Creek, Town of",2013,3,0,0,0,0
"1184",18003,"Castle Rock, Town of",2011,2,0,18300000,70755000,89055000
"1185",18003,"Castle Rock, Town of",2011,3,0,3225000,0,3225000
"1186",18003,"Castle Rock, Town of",2010,2,0,19468534,72170000,91638534
"1187",18003,"Castle Rock, Town of",2010,3,0,3470791,0,3470791
"1188",18003,"Castle Rock, Town of",2014,2,0,14425068,64425000,78850068
"1189",18003,"Castle Rock, Town of",2014,3,0,2456557,0,2456557
"1190",18003,"Castle Rock, Town of",2012,2,0,16953250,69280000,86233250
"1191",18003,"Castle Rock, Town of",2012,3,0,2991750,0,2991750
"1192",18003,"Castle Rock, Town of",2013,2,0,15797250,67730000,83527250
"1193",18003,"Castle Rock, Town of",2013,3,0,2787750,0,2787750
"1194",10005,"Empire, Town of",2011,2,0,101307,7082,108389
"1195",10005,"Empire, Town of",2011,3,0,7176,0,7176
"1196",10005,"Empire, Town of",2010,2,0,126632,9956,136588
"1197",10005,"Empire, Town of",2010,3,0,13800,0,13800
"1198",10005,"Empire, Town of",2014,2,0,29992,0,29992
"1199",10005,"Empire, Town of",2014,3,0,0,0,0
"1200",10005,"Empire, Town of",2013,2,0,52807,895,53702
"1201",10005,"Empire, Town of",2013,3,0,0,0,0
"1202",10005,"Empire, Town of",2012,2,0,74622,4064,78686
"1203",10005,"Empire, Town of",2012,3,0,0,0,0
"1204",10007,"Georgetown, Town of",2011,2,0,0,2464517,2464517
"1205",10007,"Georgetown, Town of",2011,3,0,0,3515000,3515000
"1206",10007,"Georgetown, Town of",2010,2,0,0,989015,989015
"1207",10007,"Georgetown, Town of",2010,3,0,0,3199880,3199880
"1208",10007,"Georgetown, Town of",2014,2,0,0,2514616,2514616
"1209",10007,"Georgetown, Town of",2014,3,0,0,3669800,3669800
"1210",10007,"Georgetown, Town of",2012,2,0,0,2180912,2180912
"1211",10007,"Georgetown, Town of",2012,3,0,0,3325000,3325000
"1212",10007,"Georgetown, Town of",2013,2,0,0,2168332,2168332
"1213",10007,"Georgetown, Town of",2013,3,0,0,3135000,3135000
"1214",10008,"Idaho Springs, City of",2010,2,0,0,2746659,2746659
"1215",10008,"Idaho Springs, City of",2010,3,0,0,597300,597300
"1216",10008,"Idaho Springs, City of",2011,2,0,0,2576183,2576183
"1217",10008,"Idaho Springs, City of",2011,3,0,0,506636,506636
"1218",10008,"Idaho Springs, City of",2014,2,0,0,2045363,2045363
"1219",10008,"Idaho Springs, City of",2014,3,0,0,218653,218653
"1220",10008,"Idaho Springs, City of",2012,2,0,0,2402101,2402101
"1221",10008,"Idaho Springs, City of",2012,3,0,0,415974,415974
"1222",10008,"Idaho Springs, City of",2013,2,0,0,2225207,2225207
"1223",10008,"Idaho Springs, City of",2013,3,0,0,319980,319980
"1224",10009,"Silver Plume, Town of",2011,2,0,384736,0,384736
"1225",10009,"Silver Plume, Town of",2011,3,0,0,129573,129573
"1226",10009,"Silver Plume, Town of",2010,2,0,389333,0,389333
"1227",10009,"Silver Plume, Town of",2010,3,0,53100,0,53100
"1228",10009,"Silver Plume, Town of",2013,2,0,374922,0,374922
"1229",10009,"Silver Plume, Town of",2013,3,0,0,117748,117748
"1230",10009,"Silver Plume, Town of",2014,2,0,369689,0,369689
"1231",10009,"Silver Plume, Town of",2014,3,0,0,111746,111746
"1232",10009,"Silver Plume, Town of",2012,2,0,379983,0,379983
"1233",10009,"Silver Plume, Town of",2012,3,0,0,123690,123690
"1234",8007,"Salida, City of",2010,2,0,3255000,116643,3371643
"1235",8007,"Salida, City of",2010,3,0,0,188411,188411
"1236",8007,"Salida, City of",2011,2,0,3005000,653433,3658433
"1237",8007,"Salida, City of",2011,3,0,0,0,0
"1238",8007,"Salida, City of",2013,2,0,2495000,594885,3089885
"1239",8007,"Salida, City of",2013,3,0,0,11970700,11970700
"1240",8007,"Salida, City of",2012,2,0,2745000,631187,3376187
"1241",8007,"Salida, City of",2012,3,0,0,12103000,12103000
"1242",8007,"Salida, City of",2014,2,0,2220000,828131,3048131
"1243",8007,"Salida, City of",2014,3,0,0,11724004,11724004
"1244",7042,"Ward, Town of",2011,2,0,0,0,0
"1245",7042,"Ward, Town of",2010,2,0,0,0,0
"1246",7042,"Ward, Town of",2012,2,0,0,0,0
"1247",7042,"Ward, Town of",2014,2,0,0,0,0
"1248",7042,"Ward, Town of",2013,2,0,0,0,0
"1249",6005,"Las Animas, City of",2010,2,0,942000,757866,1699866
"1250",6005,"Las Animas, City of",2010,3,0,0,884462,884462
"1251",6005,"Las Animas, City of",2012,2,0,901000,703733,1604733
"1252",6005,"Las Animas, City of",2012,3,0,0,1035883,1035883
"1253",6005,"Las Animas, City of",2011,2,0,922000,730800,1652800
"1254",6005,"Las Animas, City of",2011,3,0,0,1116687,1116687
"1255",6005,"Las Animas, City of",2014,2,0,856200,649600,1505800
"1256",6005,"Las Animas, City of",2014,3,0,0,961421,961421
"1257",6005,"Las Animas, City of",2013,2,0,879100,676667,1555767
"1258",6005,"Las Animas, City of",2013,3,0,0,937827,937827
"1259",7018,"Jamestown, Town of",2010,2,0,0,16929,16929
"1260",7018,"Jamestown, Town of",2012,2,0,0,7165,7165
"1261",7018,"Jamestown, Town of",2011,2,0,0,10987,10987
"1262",7018,"Jamestown, Town of",2013,2,0,0,3670,3670
"1263",7018,"Jamestown, Town of",2014,2,0,0,0,0
"1264",7020,"Lafayette, City of",2010,2,635000,15645000,118647,16398647
"1265",7020,"Lafayette, City of",2010,3,0,0,5723859,5723859
"1266",7020,"Lafayette, City of",2011,2,325000,15645000,104762,16074762
"1267",7020,"Lafayette, City of",2011,3,0,0,5288703,5288703
"1268",7020,"Lafayette, City of",2012,2,0,15215000,89741,15304741
"1269",7020,"Lafayette, City of",2012,3,0,0,4849885,4849885
"1270",7020,"Lafayette, City of",2014,2,0,13550000,57002,13607002
"1271",7020,"Lafayette, City of",2014,3,0,0,3908088,3908088
"1272",7020,"Lafayette, City of",2013,2,0,14395000,73784,14468784
"1273",7020,"Lafayette, City of",2013,3,0,0,4389493,4389493
"1274",7032,"Lyons, Town of",2012,2,0,0,2991861,2991861
"1275",7032,"Lyons, Town of",2012,3,0,0,0,0
"1276",7032,"Lyons, Town of",2010,2,0,0,3428057,3428057
"1277",7032,"Lyons, Town of",2010,3,0,0,0,0
"1278",7032,"Lyons, Town of",2011,2,0,0,3209959,3209959
"1279",7032,"Lyons, Town of",2011,3,0,0,0,0
"1280",7032,"Lyons, Town of",2014,1,0,0,7744479,7744479
"1281",7032,"Lyons, Town of",2013,2,0,0,2768170,2768170
"1282",7032,"Lyons, Town of",2013,3,0,0,0,0
"1283",30020,"Edgewater, City of",2011,1,0,0,0,0
"1284",30020,"Edgewater, City of",2012,1,0,0,0,0
"1285",30020,"Edgewater, City of",2010,1,0,0,0,0
"1286",30020,"Edgewater, City of",2014,1,0,0,0,0
"1287",30020,"Edgewater, City of",2013,1,0,0,0,0
"1288",30035,"Golden, City of",2010,2,0,8700000,0,8700000
"1289",30035,"Golden, City of",2010,3,0,0,0,0
"1290",30035,"Golden, City of",2011,2,0,7890000,0,7890000
"1291",30035,"Golden, City of",2011,3,0,0,0,0
"1292",30035,"Golden, City of",2014,2,0,5810000,0,5810000
"1293",30035,"Golden, City of",2014,3,0,0,0,0
"1294",30035,"Golden, City of",2012,2,0,7045000,0,7045000
"1295",30035,"Golden, City of",2012,3,0,0,0,0
"1296",30035,"Golden, City of",2013,2,0,6510000,0,6510000
"1297",30035,"Golden, City of",2013,3,0,0,0,0
"1298",29006,"Walden, Town of",2011,1,0,0,944396,944396
"1299",29006,"Walden, Town of",2013,1,0,0,839309,839309
"1300",29006,"Walden, Town of",2010,1,0,0,980252,980252
"1301",29006,"Walden, Town of",2014,1,0,0,790042,790042
"1302",29006,"Walden, Town of",2012,1,0,0,895749,895749
"1303",26010,"Marble, Town of",2012,2,0,0,342463,342463
"1304",26010,"Marble, Town of",2013,2,0,0,319679,319679
"1305",26010,"Marble, Town of",2014,2,0,0,312466,312466
"1306",27005,"Lake City, Town of",2010,1,0,0,13911,13911
"1307",27005,"Lake City, Town of",2011,1,0,0,7125,7125
"1308",27005,"Lake City, Town of",2013,1,0,0,0,0
"1309",27005,"Lake City, Town of",2012,1,0,0,0,0
"1310",27005,"Lake City, Town of",2014,1,0,0,0,0
"1311",28010,"Walsenburg, City of",2010,1,0,9625000,278791,9903791
"1312",28010,"Walsenburg, City of",2011,1,0,9445000,160491,9605491
"1313",28010,"Walsenburg, City of",2012,1,0,9245000,131327,9376327
"1314",28010,"Walsenburg, City of",2013,1,0,9020000,99338,9119338
"1315",28010,"Walsenburg, City of",2014,1,0,8760000,68006,8828006
"1316",25006,"Fraser, Town of",2010,2,0,0,0,0
"1317",25006,"Fraser, Town of",2010,3,0,0,0,0
"1318",25006,"Fraser, Town of",2011,2,0,0,0,0
"1319",25006,"Fraser, Town of",2011,3,0,0,0,0
"1320",25006,"Fraser, Town of",2014,2,0,0,0,0
"1321",25006,"Fraser, Town of",2014,3,0,0,0,0
"1322",25006,"Fraser, Town of",2012,2,0,0,0,0
"1323",25006,"Fraser, Town of",2012,3,0,0,0,0
"1324",25006,"Fraser, Town of",2013,2,0,0,0,0
"1325",25006,"Fraser, Town of",2013,3,0,0,0,0
"1326",25008,"Granby, Town of",2014,2,0,0,165960,165960
"1327",25008,"Granby, Town of",2014,3,0,0,0,0
"1328",25008,"Granby, Town of",2012,2,0,0,192032,192032
"1329",25008,"Granby, Town of",2012,3,0,0,0,0
"1330",25008,"Granby, Town of",2011,2,0,0,204320,204320
"1331",25008,"Granby, Town of",2011,3,0,0,0,0
"1332",25008,"Granby, Town of",2010,2,0,0,216137,216137
"1333",25008,"Granby, Town of",2010,3,0,0,0,0
"1334",25008,"Granby, Town of",2013,2,0,0,179251,179251
"1335",25008,"Granby, Town of",2013,3,0,0,0,0
"1336",25014,"Grand Lake, Town of",2010,2,0,0,332650,332650
"1337",25014,"Grand Lake, Town of",2011,2,0,0,267378,267378
"1338",25014,"Grand Lake, Town of",2014,2,0,0,0,0
"1339",25014,"Grand Lake, Town of",2012,2,0,0,199121,199121
"1340",25014,"Grand Lake, Town of",2013,2,0,0,0,0
"1341",25015,"Hot Sulphur Springs, Town of",2012,2,0,0,1137500,1137500
"1342",25015,"Hot Sulphur Springs, Town of",2012,3,0,0,88782,88782
"1343",25015,"Hot Sulphur Springs, Town of",2010,2,0,0,1267500,1267500
"1344",25015,"Hot Sulphur Springs, Town of",2010,3,0,0,127083,127083
"1345",25015,"Hot Sulphur Springs, Town of",2011,2,0,0,1202500,1202500
"1346",25015,"Hot Sulphur Springs, Town of",2011,3,0,0,108399,108399
"1347",25015,"Hot Sulphur Springs, Town of",2014,2,0,0,1007500,1007500
"1348",25015,"Hot Sulphur Springs, Town of",2014,3,0,0,693916,693916
"1349",25015,"Hot Sulphur Springs, Town of",2013,2,0,0,1072500,1072500
"1350",25015,"Hot Sulphur Springs, Town of",2013,3,0,0,745155,745155
"1351",25018,"Kremmling, Town of",2010,2,0,390000,1559463,1949463
"1352",25018,"Kremmling, Town of",2011,2,0,370000,1525034,1895034
"1353",25018,"Kremmling, Town of",2012,2,0,350000,1489142,1839142
"1354",25018,"Kremmling, Town of",2013,2,0,330000,1451724,1781724
"1355",25018,"Kremmling, Town of",2014,2,0,310000,1412716,1722716
"1356",19003,"Avon, Town of",2010,2,0,0,0,0
"1357",19003,"Avon, Town of",2011,2,0,0,0,0
"1358",19003,"Avon, Town of",2012,2,0,0,0,0
"1359",19003,"Avon, Town of",2014,2,0,0,0,0
"1360",19003,"Avon, Town of",2013,2,0,0,0,0
"1361",24001,"Black Hawk, City of",2010,2,950000,10395250,0,11345250
"1362",24001,"Black Hawk, City of",2011,2,490000,9528000,0,10018000
"1363",24001,"Black Hawk, City of",2012,2,0,8489500,0,8489500
"1364",24001,"Black Hawk, City of",2013,2,0,17692750,0,17692750
"1365",24001,"Black Hawk, City of",2014,2,0,16862500,0,16862500
"1366",23004,"Carbondale, Town of",2010,2,0,0,676671,676671
"1367",23004,"Carbondale, Town of",2010,3,0,0,0,0
"1368",23004,"Carbondale, Town of",2011,2,0,0,545917,545917
"1369",23004,"Carbondale, Town of",2011,3,0,0,0,0
"1370",23004,"Carbondale, Town of",2013,2,0,0,0,0
"1371",23004,"Carbondale, Town of",2013,3,0,0,0,0
"1372",23004,"Carbondale, Town of",2012,2,0,0,0,0
"1373",23004,"Carbondale, Town of",2012,3,0,0,0,0
"1374",23004,"Carbondale, Town of",2014,2,0,0,0,0
"1375",23004,"Carbondale, Town of",2014,3,0,0,0,0
"1376",22002,"Canon City, City of",2011,2,0,0,0,0
"1377",22002,"Canon City, City of",2010,2,0,0,0,0
"1378",22002,"Canon City, City of",2012,2,0,0,0,0
"1379",22002,"Canon City, City of",2014,2,0,0,0,0
"1380",22002,"Canon City, City of",2013,2,0,0,0,0
"1381",22011,"Florence, City of",2010,2,0,2426071,12803986,15230057
"1382",22011,"Florence, City of",2011,2,0,2375000,12051986,14426986
"1383",22011,"Florence, City of",2014,2,0,10770000,9730620,20500620
"1384",22011,"Florence, City of",2012,2,0,2310000,11290509,13600509
"1385",22011,"Florence, City of",2013,2,0,10770000,10516734,21286734
"1386",22018,"Rockvale, Town of",2011,2,0,0,0,0
"1387",22018,"Rockvale, Town of",2010,2,0,0,0,0
"1388",22018,"Rockvale, Town of",2012,2,0,0,0,0
"1389",22018,"Rockvale, Town of",2014,2,0,0,0,0
"1390",22018,"Rockvale, Town of",2013,2,0,0,0,0
"1391",22019,"Williamsburg, Town of",2011,2,0,0,0,0
"1392",22019,"Williamsburg, Town of",2010,2,0,0,0,0
"1393",22019,"Williamsburg, Town of",2012,2,0,0,0,0
"1394",22019,"Williamsburg, Town of",2013,2,0,0,0,0
"1395",22019,"Williamsburg, Town of",2014,2,0,0,826000,826000
"1396",2003,"Alamosa, City of",2012,1,0,9055664,0,9055664
"1397",2003,"Alamosa, City of",2011,1,0,9591568,0,9591568
"1398",2003,"Alamosa, City of",2010,1,0,10044760,0,10044760
"1399",2003,"Alamosa, City of",2014,1,0,8058976,0,8058976
"1400",2003,"Alamosa, City of",2013,1,0,8571970,0,8571970
"1401",3033,"Deer Trail, Town of",2011,2,0,0,247200,247200
"1402",3033,"Deer Trail, Town of",2011,3,0,668720,0,668720
"1403",3033,"Deer Trail, Town of",2010,2,0,0,251200,251200
"1404",3033,"Deer Trail, Town of",2010,3,0,677610,0,677610
"1405",3033,"Deer Trail, Town of",2013,2,0,0,238600,238600
"1406",3033,"Deer Trail, Town of",2013,3,0,642245,0,642245
"1407",3033,"Deer Trail, Town of",2014,2,0,0,234000,234000
"1408",3033,"Deer Trail, Town of",2014,3,0,631867,0,631867
"1409",3033,"Deer Trail, Town of",2012,2,0,0,243000,243000
"1410",3033,"Deer Trail, Town of",2012,3,0,652208,0,652208
"1411",39012,"De Beque, Town of",2010,2,0,0,312547,312547
"1412",39012,"De Beque, Town of",2010,3,0,0,0,0
"1413",39012,"De Beque, Town of",2011,2,0,0,289181,289181
"1414",39012,"De Beque, Town of",2011,3,0,0,0,0
"1415",39012,"De Beque, Town of",2012,2,0,0,264745,264745
"1416",39012,"De Beque, Town of",2012,3,0,0,0,0
"1417",39012,"De Beque, Town of",2014,2,0,0,234545,234545
"1418",39012,"De Beque, Town of",2014,3,0,0,0,0
"1419",39012,"De Beque, Town of",2013,2,0,0,270352,270352
"1420",39012,"De Beque, Town of",2013,3,0,0,0,0
"1421",36001,"Aguilar, Town of",2011,2,0,0,1139187,1139187
"1422",36001,"Aguilar, Town of",2011,3,0,0,44000,44000
"1423",36001,"Aguilar, Town of",2012,2,0,0,1123018,1123018
"1424",36001,"Aguilar, Town of",2012,3,0,0,0,0
"1425",36001,"Aguilar, Town of",2010,2,0,0,1155450,1155450
"1426",36001,"Aguilar, Town of",2010,3,0,0,55000,55000
"1427",36001,"Aguilar, Town of",2013,2,0,0,1088500,1088500
"1428",36001,"Aguilar, Town of",2013,3,0,0,0,0
"1429",36001,"Aguilar, Town of",2014,2,0,0,1070869,1070869
"1430",36001,"Aguilar, Town of",2014,3,0,0,0,0
"1431",36005,"Kim, Town of",2012,2,0,0,102267,102267
"1432",36005,"Kim, Town of",2011,2,0,0,106200,106200
"1433",36005,"Kim, Town of",2010,2,0,0,110134,110134
"1434",36005,"Kim, Town of",2013,2,0,0,98334,98334
"1435",36005,"Kim, Town of",2014,2,0,0,94400,94400
"1436",36010,"Starkville, Town of",2011,2,0,0,159488,159488
"1437",36010,"Starkville, Town of",2010,2,0,0,162988,162988
"1438",36010,"Starkville, Town of",2012,2,0,0,141065,141065
"1439",36010,"Starkville, Town of",2014,2,0,0,131661,131661
"1440",36010,"Starkville, Town of",2013,2,0,0,136363,136363
"1441",37004,"Genoa, Town of",2010,2,0,0,154583,154583
"1442",37004,"Genoa, Town of",2010,3,0,67848,140130,207978
"1443",37004,"Genoa, Town of",2012,2,0,0,144054,144054
"1444",37004,"Genoa, Town of",2012,3,0,53448,139666,193114
"1445",37004,"Genoa, Town of",2011,2,0,0,148750,148750
"1446",37004,"Genoa, Town of",2011,3,0,60848,138229,199077
"1447",37004,"Genoa, Town of",2013,2,0,0,137083,137083
"1448",37004,"Genoa, Town of",2013,3,0,45648,135557,181205
"1449",37004,"Genoa, Town of",2014,2,0,0,131250,131250
"1450",37004,"Genoa, Town of",2014,3,0,37548,132035,169583
"1451",35047,"Wellington, Town of",2010,2,276000,0,1247308,1523308
"1452",35047,"Wellington, Town of",2010,3,0,0,3239188,3239188
"1453",35047,"Wellington, Town of",2011,2,260000,0,1165645,1425645
"1454",35047,"Wellington, Town of",2011,3,0,0,3011686,3011686
"1455",35047,"Wellington, Town of",2012,2,244000,0,1080695,1324695
"1456",35047,"Wellington, Town of",2012,3,0,0,2778768,2778768
"1457",35047,"Wellington, Town of",2013,2,227000,0,992329,1219329
"1458",35047,"Wellington, Town of",2013,3,0,0,2540433,2540433
"1459",35047,"Wellington, Town of",2014,2,209000,0,900408,1109408
"1460",35047,"Wellington, Town of",2014,3,2500000,0,2296682,4796682
"1461",35026,"Loveland, City of",2011,2,0,0,0,0
"1462",35026,"Loveland, City of",2011,3,0,0,0,0
"1463",35026,"Loveland, City of",2010,2,0,0,0,0
"1464",35026,"Loveland, City of",2010,3,0,0,0,0
"1465",35026,"Loveland, City of",2014,2,0,1e+05,0,1e+05
"1466",35026,"Loveland, City of",2014,3,0,0,0,0
"1467",35026,"Loveland, City of",2013,2,0,1e+05,0,1e+05
"1468",35026,"Loveland, City of",2013,3,0,0,0,0
"1469",35026,"Loveland, City of",2012,2,0,0,0,0
"1470",35026,"Loveland, City of",2012,3,0,0,0,0
"1471",32023,"Vona, Town of",2012,2,0,0,72647,72647
"1472",32023,"Vona, Town of",2012,3,0,0,24288,24288
"1473",32023,"Vona, Town of",2010,2,0,0,76700,76700
"1474",32023,"Vona, Town of",2010,3,0,0,34903,34903
"1475",32023,"Vona, Town of",2011,2,0,0,75900,75900
"1476",32023,"Vona, Town of",2011,3,0,0,29713,29713
"1477",32023,"Vona, Town of",2014,2,0,0,69100,69100
"1478",32023,"Vona, Town of",2014,3,0,0,12684,12684
"1479",32023,"Vona, Town of",2013,3,0,0,18635,18635
"1480",32023,"Vona, Town of",2013,2,0,0,71700,71700
"1481",32004,"Burlington, City of",2011,1,0,0,1884372,1884372
"1482",32004,"Burlington, City of",2010,1,0,0,1974000,1974000
"1483",32004,"Burlington, City of",2012,1,0,0,1793845,1793845
"1484",32004,"Burlington, City of",2014,1,0,0,5250000,5250000
"1485",32004,"Burlington, City of",2013,1,0,0,1542062,1542062
"1486",32010,"Flagler, Town of",2010,2,0,0,225969,225969
"1487",32010,"Flagler, Town of",2010,3,0,0,0,0
"1488",32010,"Flagler, Town of",2011,2,0,0,208003,208003
"1489",32010,"Flagler, Town of",2011,3,0,0,0,0
"1490",32010,"Flagler, Town of",2012,2,0,0,189139,189139
"1491",32010,"Flagler, Town of",2012,3,0,0,0,0
"1492",32010,"Flagler, Town of",2013,2,0,0,169332,169332
"1493",32010,"Flagler, Town of",2013,3,0,0,0,0
"1494",32010,"Flagler, Town of",2014,2,0,0,148534,148534
"1495",32010,"Flagler, Town of",2014,3,0,0,0,0
"1496",26004,"Crested Butte, Town of",2012,1,672840,0,1765019,2437859
"1497",26004,"Crested Butte, Town of",2011,1,822360,0,1428883,2251243
"1498",26004,"Crested Butte, Town of",2014,1,357780,0,1602085,1959865
"1499",26004,"Crested Butte, Town of",2010,1,966540,0,1900000,2866540
"1500",26004,"Crested Butte, Town of",2013,1,517980,0,1684363,2202343
"1501",26008,"Gunnison, City of",2010,2,0,0,0,0
"1502",26008,"Gunnison, City of",2010,3,0,0,0,0
"1503",26008,"Gunnison, City of",2011,2,0,0,0,0
"1504",26008,"Gunnison, City of",2011,3,0,0,0,0
"1505",26008,"Gunnison, City of",2012,2,0,0,0,0
"1506",26008,"Gunnison, City of",2012,3,0,0,0,0
"1507",26008,"Gunnison, City of",2014,2,0,0,0,0
"1508",26008,"Gunnison, City of",2014,3,0,0,0,0
"1509",26008,"Gunnison, City of",2013,2,0,0,0,0
"1510",26008,"Gunnison, City of",2013,3,0,0,0,0
"1511",28007,"La Veta, Town of",2010,2,0,0,1102604,1102604
"1512",28007,"La Veta, Town of",2010,3,0,0,0,0
"1513",28007,"La Veta, Town of",2012,2,0,0,1153199,1153199
"1514",28007,"La Veta, Town of",2012,3,0,0,0,0
"1515",28007,"La Veta, Town of",2011,2,0,0,1073022,1073022
"1516",28007,"La Veta, Town of",2011,3,0,0,0,0
"1517",28007,"La Veta, Town of",2013,2,0,0,1356314,1356314
"1518",28007,"La Veta, Town of",2013,3,0,0,0,0
"1519",28007,"La Veta, Town of",2014,2,0,0,1316338,1316338
"1520",28007,"La Veta, Town of",2014,3,0,0,270000,270000
"1521",22001,"Brookside, Town of",2011,2,0,0,137337,137337
"1522",22001,"Brookside, Town of",2010,2,0,0,140426,140426
"1523",22001,"Brookside, Town of",2014,2,0,0,127448,127448
"1524",22001,"Brookside, Town of",2012,2,0,0,134147,134147
"1525",22001,"Brookside, Town of",2013,2,0,0,130852,130852
"1526",22006,"Coal Creek, Town of",2010,2,0,0,0,0
"1527",22006,"Coal Creek, Town of",2012,2,0,0,0,0
"1528",22006,"Coal Creek, Town of",2011,2,0,0,0,0
"1529",22006,"Coal Creek, Town of",2014,2,0,0,339605,339605
"1530",22006,"Coal Creek, Town of",2013,2,0,0,0,0
"1531",21036,"Ramah, Town of",2011,2,0,0,54200,54200
"1532",21036,"Ramah, Town of",2011,3,0,0,54200,54200
"1533",21036,"Ramah, Town of",2010,2,0,0,55500,55500
"1534",21036,"Ramah, Town of",2010,3,0,0,55500,55500
"1535",21036,"Ramah, Town of",2012,2,0,0,52800,52800
"1536",21036,"Ramah, Town of",2012,3,0,0,52800,52800
"1537",21036,"Ramah, Town of",2013,2,0,0,51350,51350
"1538",21036,"Ramah, Town of",2013,3,0,0,51350,51350
"1539",21036,"Ramah, Town of",2014,2,0,0,49850,49850
"1540",21036,"Ramah, Town of",2014,3,0,0,49850,49850
"1541",5003,"Campo, Town of",2012,2,0,0,138400,138400
"1542",5003,"Campo, Town of",2011,1,0,0,141000,141000
"1543",5003,"Campo, Town of",2010,1,0,0,143500,143500
"1544",5003,"Campo, Town of",2013,2,0,0,135705,135705
"1545",5006,"Pritchett, Town of",2011,2,0,0,163333,163333
"1546",5006,"Pritchett, Town of",2011,3,0,0,64500,64500
"1547",5006,"Pritchett, Town of",2010,2,0,0,170000,170000
"1548",5006,"Pritchett, Town of",2010,3,0,0,70000,70000
"1549",5006,"Pritchett, Town of",2012,2,0,0,156667,156667
"1550",5006,"Pritchett, Town of",2012,3,0,0,59000,59000
"1551",5006,"Pritchett, Town of",2014,2,0,0,143333,143333
"1552",5006,"Pritchett, Town of",2014,3,0,0,46500,46500
"1553",5006,"Pritchett, Town of",2013,2,0,0,150000,150000
"1554",5006,"Pritchett, Town of",2013,3,0,0,53000,53000
"1555",5019,"Vilas, Town of",2011,1,0,203484,0,203484
"1556",5019,"Vilas, Town of",2010,1,0,209615,0,209615
"1557",5019,"Vilas, Town of",2013,2,0,197244,0,197244
"1558",5019,"Vilas, Town of",2012,2,0,200437,0,200437
"1559",5019,"Vilas, Town of",2014,2,0,193897,0,193897
"1560",5023,"Walsh, Town of",2011,1,0,867603,0,867603
"1561",5023,"Walsh, Town of",2010,1,0,877546,0,877546
"1562",5023,"Walsh, Town of",2012,1,0,0,0,0
"1563",5023,"Walsh, Town of",2014,1,0,829823,0,829823
"1564",5023,"Walsh, Town of",2013,1,0,0,0,0
"1565",15003,"Cedaredge, Town of",2010,2,0,2293226,296966,2590192
"1566",15003,"Cedaredge, Town of",2010,3,0,0,0,0
"1567",15003,"Cedaredge, Town of",2011,2,0,2236285,211273,2447558
"1568",15003,"Cedaredge, Town of",2011,3,0,0,0,0
"1569",15003,"Cedaredge, Town of",2012,2,0,2197379,122194,2319573
"1570",15003,"Cedaredge, Town of",2012,3,0,0,0,0
"1571",15003,"Cedaredge, Town of",2014,2,0,2114990,0,2114990
"1572",15003,"Cedaredge, Town of",2014,3,0,0,0,0
"1573",15003,"Cedaredge, Town of",2013,2,0,2156852,29557,2186409
"1574",15003,"Cedaredge, Town of",2013,3,0,0,0,0
"1575",15005,"Crawford, Town of",2012,2,0,0,0,0
"1576",15005,"Crawford, Town of",2012,3,0,0,0,0
"1577",15005,"Crawford, Town of",2011,2,0,0,0,0
"1578",15005,"Crawford, Town of",2011,3,0,0,0,0
"1579",15005,"Crawford, Town of",2010,2,0,0,0,0
"1580",15005,"Crawford, Town of",2010,3,0,0,0,0
"1581",15005,"Crawford, Town of",2013,2,0,0,0,0
"1582",15005,"Crawford, Town of",2013,3,0,0,0,0
"1583",15005,"Crawford, Town of",2014,3,0,0,0,0
"1584",15005,"Crawford, Town of",2014,2,0,0,0,0
"1585",15015,"Delta, City of",2011,3,0,5e+05,2009154,2509154
"1586",15015,"Delta, City of",2011,2,0,0,0,0
"1587",15015,"Delta, City of",2010,3,0,513000,2041524,2554524
"1588",15015,"Delta, City of",2010,2,0,0,0,0
"1589",15015,"Delta, City of",2013,3,0,2367884,0,2367884
"1590",15015,"Delta, City of",2013,2,0,0,0,0
"1591",15015,"Delta, City of",2014,3,0,2274417,0,2274417
"1592",15015,"Delta, City of",2014,2,0,0,0,0
"1593",15015,"Delta, City of",2012,3,0,2458171,0,2458171
"1594",15015,"Delta, City of",2012,2,0,0,0,0
"1595",13002,"Crowley, Town of",2011,3,44000,0,155004,199004
"1596",13002,"Crowley, Town of",2011,2,64000,0,0,64000
"1597",13002,"Crowley, Town of",2010,3,47500,0,0,47500
"1598",13002,"Crowley, Town of",2010,2,69000,0,0,69000
"1599",13002,"Crowley, Town of",2014,2,48000,0,96667,144667
"1600",13002,"Crowley, Town of",2014,3,31000,0,1758138,1789138
"1601",13002,"Crowley, Town of",2013,2,5400,0,53179,58579
"1602",13002,"Crowley, Town of",2013,3,35500,0,1825565,1861065
"1603",13002,"Crowley, Town of",2012,2,59000,0,45854,104854
"1604",13002,"Crowley, Town of",2012,3,40000,0,1946055,1986055
"1605",13004,"Olney Springs, Town of",2011,1,59000,0,373244,432244
"1606",13004,"Olney Springs, Town of",2010,1,65000,0,378366,443366
"1607",13004,"Olney Springs, Town of",2013,2,46000,0,685332,731332
"1608",13004,"Olney Springs, Town of",2013,3,0,0,0,0
"1609",13004,"Olney Springs, Town of",2012,1,53000,0,367903,420903
"1610",13004,"Olney Springs, Town of",2014,2,39000,0,356522,395522
"1611",13004,"Olney Springs, Town of",2014,3,0,0,306850,306850
"1612",13007,"Sugar City, Town of",2011,2,0,307809,0,307809
"1613",13007,"Sugar City, Town of",2011,3,0,0,300050,300050
"1614",13007,"Sugar City, Town of",2010,3,0,0,318600,318600
"1615",13007,"Sugar City, Town of",2010,2,0,312033,0,312033
"1616",13007,"Sugar City, Town of",2014,3,0,0,234550,234550
"1617",13007,"Sugar City, Town of",2014,2,0,0,294019,294019
"1618",13007,"Sugar City, Town of",2012,2,0,303405,0,303405
"1619",13007,"Sugar City, Town of",2012,3,0,0,281500,281500
"1620",13007,"Sugar City, Town of",2013,2,0,0,298810,298810
"1621",13007,"Sugar City, Town of",2013,3,0,0,252396,252396
"1622",11001,"Antonito, Town of",2011,1,0,0,2941,2941
"1623",11001,"Antonito, Town of",2012,1,0,0,0,0
"1624",11001,"Antonito, Town of",2010,1,0,3135,20850,23985
"1625",11001,"Antonito, Town of",2014,1,0,0,0,0
"1626",11001,"Antonito, Town of",2013,1,0,0,0,0
"1627",11009,"La Jara, Town of",2011,1,0,0,678750,678750
"1628",11009,"La Jara, Town of",2010,1,0,0,726250,726250
"1629",11009,"La Jara, Town of",2013,1,0,0,583750,583750
"1630",11009,"La Jara, Town of",2014,1,0,0,536250,536250
"1631",11009,"La Jara, Town of",2012,1,0,0,631250,631250
"1632",11010,"Manassa, Town of",2012,3,0,0,563900,563900
"1633",11010,"Manassa, Town of",2012,2,0,0,468255,468255
"1634",11010,"Manassa, Town of",2011,2,0,0,484685,484685
"1635",11010,"Manassa, Town of",2011,3,0,0,576400,576400
"1636",11010,"Manassa, Town of",2010,2,0,0,72000,72000
"1637",11010,"Manassa, Town of",2010,3,0,0,588300,588300
"1638",11010,"Manassa, Town of",2013,2,0,0,451825,451825
"1639",11010,"Manassa, Town of",2013,3,0,0,550800,550800
"1640",11010,"Manassa, Town of",2014,2,0,0,435395,435395
"1641",11010,"Manassa, Town of",2014,3,0,0,537100,537100
"1642",11013,"Romeo, Town of",2010,1,0,0,96793,96793
"1643",11013,"Romeo, Town of",2011,1,0,0,163076,163076
"1644",11013,"Romeo, Town of",2014,1,0,0,139762,139762
"1645",11013,"Romeo, Town of",2012,1,0,0,171527,171527
"1646",11013,"Romeo, Town of",2013,1,0,0,156121,156121
"1647",9007,"Cheyenne Wells, Town of",2010,2,0,0,0,0
"1648",9007,"Cheyenne Wells, Town of",2011,2,0,0,0,0
"1649",9007,"Cheyenne Wells, Town of",2012,2,0,0,0,0
"1650",9007,"Cheyenne Wells, Town of",2014,2,0,0,0,0
"1651",9007,"Cheyenne Wells, Town of",2013,2,0,0,0,0
"1652",9013,"Kit Carson, Town of",2011,1,0,0,239575,239575
"1653",9013,"Kit Carson, Town of",2010,1,0,0,252525,252525
"1654",9013,"Kit Carson, Town of",2013,2,0,0,213675,213675
"1655",9013,"Kit Carson, Town of",2014,1,0,0,200725,200725
"1656",9013,"Kit Carson, Town of",2012,1,0,0,226625,226625
"1657",3041,"Englewood, City of",2011,2,4990000,0,6173023,11163023
"1658",3041,"Englewood, City of",2011,3,0,0,45547351,45547351
"1659",3041,"Englewood, City of",2010,2,5115000,0,6968657,12083657
"1660",3041,"Englewood, City of",2010,3,0,0,48935027,48935027
"1661",3041,"Englewood, City of",2012,2,11480000,0,5354069,16834069
"1662",3041,"Englewood, City of",2012,3,0,0,42276467,42276467
"1663",3041,"Englewood, City of",2013,2,11330000,0,0,11330000
"1664",3041,"Englewood, City of",2013,3,0,0,39741116,39741116
"1665",3041,"Englewood, City of",2014,2,11180000,0,3640712,14820712
"1666",3041,"Englewood, City of",2014,3,0,0,37080765,37080765
"1667",3043,"Glendale, City of",2010,2,0,0,1773771,1773771
"1668",3043,"Glendale, City of",2010,3,0,0,8080061,8080061
"1669",3043,"Glendale, City of",2011,2,0,0,1508818,1508818
"1670",3043,"Glendale, City of",2011,3,0,0,7676056,7676056
"1671",3043,"Glendale, City of",2012,2,0,0,1232322,1232322
"1672",3043,"Glendale, City of",2012,3,0,0,7266595,7266595
"1673",3043,"Glendale, City of",2013,2,0,0,943758,943758
"1674",3043,"Glendale, City of",2013,3,0,0,6851673,6851673
"1675",3043,"Glendale, City of",2014,2,0,0,642574,642574
"1676",3043,"Glendale, City of",2014,3,0,0,6425832,6425832
"1677",45009,"Manzanola, Town of",2012,2,0,0,106908,106908
"1678",45009,"Manzanola, Town of",2012,3,0,0,104338,104338
"1679",45009,"Manzanola, Town of",2010,2,0,0,136662,136662
"1680",45009,"Manzanola, Town of",2010,3,0,0,118128,118128
"1681",45009,"Manzanola, Town of",2011,2,0,0,121904,121904
"1682",45009,"Manzanola, Town of",2011,3,0,0,114074,114074
"1683",45009,"Manzanola, Town of",2013,2,0,0,88661,88661
"1684",45009,"Manzanola, Town of",2013,3,0,0,94379,94379
"1685",45009,"Manzanola, Town of",2014,2,0,51918,18234,70152
"1686",45009,"Manzanola, Town of",2014,3,0,0,84185,84185
"1687",44007,"Hillrose, Town of",2010,2,0,0,844952,844952
"1688",44007,"Hillrose, Town of",2010,3,0,0,70562,70562
"1689",44007,"Hillrose, Town of",2012,2,0,0,786444,786444
"1690",44007,"Hillrose, Town of",2012,3,0,0,60505,60505
"1691",44007,"Hillrose, Town of",2011,2,0,0,815752,815752
"1692",44007,"Hillrose, Town of",2011,3,0,0,65662,65662
"1693",44007,"Hillrose, Town of",2013,2,0,0,757023,757023
"1694",44007,"Hillrose, Town of",2013,3,0,0,57701,57701
"1695",44007,"Hillrose, Town of",2014,2,0,0,718775,718775
"1696",44007,"Hillrose, Town of",2014,3,0,0,54757,54757
"1697",43005,"Naturita, Town of",2010,1,0,0,0,0
"1698",43005,"Naturita, Town of",2013,1,0,0,189943,189943
"1699",43005,"Naturita, Town of",2011,1,0,0,0,0
"1700",43005,"Naturita, Town of",2014,1,0,0,110611,110611
"1701",43005,"Naturita, Town of",2012,1,0,0,199245,199245
"1702",41004,"Craig, City of",2010,2,0,0,5145727,5145727
"1703",41004,"Craig, City of",2010,3,0,0,342422,342422
"1704",41004,"Craig, City of",2013,2,0,0,4388680,4388680
"1705",41004,"Craig, City of",2013,3,0,0,144640,144640
"1706",41004,"Craig, City of",2011,2,0,0,4898864,4898864
"1707",41004,"Craig, City of",2011,3,0,0,278218,278218
"1708",41004,"Craig, City of",2014,2,0,0,4125359,4125359
"1709",41004,"Craig, City of",2014,3,0,0,79362,79362
"1710",41004,"Craig, City of",2012,2,0,0,4646515,4646515
"1711",41004,"Craig, City of",2012,3,0,0,214014,214014
"1712",1009,"Federal Heights, City of",2010,1,0,0,0,0
"1713",1009,"Federal Heights, City of",2011,1,0,0,0,0
"1714",1009,"Federal Heights, City of",2013,1,0,0,0,0
"1715",1009,"Federal Heights, City of",2012,1,0,0,0,0
"1716",1009,"Federal Heights, City of",2014,1,0,0,0,0
"1717",21030,"Manitou Springs, City of",2010,2,0,0,3587120,3587120
"1718",21030,"Manitou Springs, City of",2010,3,0,0,81316,81316
"1719",21030,"Manitou Springs, City of",2012,2,0,0,3381100,3381100
"1720",21030,"Manitou Springs, City of",2012,3,0,0,168236,168236
"1721",21030,"Manitou Springs, City of",2013,2,0,0,3430127,3430127
"1722",21030,"Manitou Springs, City of",2013,3,0,0,68806,68806
"1723",21030,"Manitou Springs, City of",2011,2,0,0,3401331,3401331
"1724",21030,"Manitou Springs, City of",2011,3,0,0,77146,77146
"1725",21030,"Manitou Springs, City of",2014,2,0,0,3162292,3162292
"1726",21030,"Manitou Springs, City of",2014,3,0,0,357568,357568
"1727",20005,"Kiowa, Town of",2010,2,0,3450534,0,3450534
"1728",20005,"Kiowa, Town of",2010,3,0,2179465,151275,2330740
"1729",20005,"Kiowa, Town of",2011,2,0,3390534,0,3390534
"1730",20005,"Kiowa, Town of",2011,3,0,2139466,141772,2281238
"1731",20005,"Kiowa, Town of",2012,2,0,3300534,0,3300534
"1732",20005,"Kiowa, Town of",2012,3,0,2079466,131793,2211259
"1733",20005,"Kiowa, Town of",2013,2,0,3300534,0,3300534
"1734",20005,"Kiowa, Town of",2013,3,0,2079466,131793,2211259
"1735",20005,"Kiowa, Town of",2014,2,0,0,0,0
"1736",20005,"Kiowa, Town of",2014,3,0,0,0,0
"1737",21006,"Calhan, Town of",2010,3,0,0,15386,15386
"1738",21006,"Calhan, Town of",2010,2,0,139500,113210,252710
"1739",21006,"Calhan, Town of",2012,3,0,0,91318,91318
"1740",21006,"Calhan, Town of",2012,2,0,132700,172052,304752
"1741",21006,"Calhan, Town of",2011,3,0,0,5441,5441
"1742",21006,"Calhan, Town of",2011,2,0,136200,97926,234126
"1743",21006,"Calhan, Town of",2014,2,0,125100,136779,261879
"1744",21006,"Calhan, Town of",2014,3,0,0,85604,85604
"1745",21006,"Calhan, Town of",2013,3,0,0,86748,86748
"1746",21006,"Calhan, Town of",2013,2,0,129000,153063,282063
"1747",19020,"Gypsum, Town of",2011,2,0,0,827154,827154
"1748",19020,"Gypsum, Town of",2011,3,0,2845000,0,2845000
"1749",19020,"Gypsum, Town of",2010,2,0,0,836487,836487
"1750",19020,"Gypsum, Town of",2010,3,0,3105000,12333,3117333
"1751",19020,"Gypsum, Town of",2012,2,0,0,817822,817822
"1752",19020,"Gypsum, Town of",2012,3,0,2570000,0,2570000
"1753",19020,"Gypsum, Town of",2014,2,0,0,798573,798573
"1754",19020,"Gypsum, Town of",2014,3,0,1990000,0,1990000
"1755",19020,"Gypsum, Town of",2013,2,0,0,808489,808489
"1756",19020,"Gypsum, Town of",2013,3,0,2290000,0,2290000
"1757",19026,"Red Cliff, Town of",2011,1,0,425717,403729,829446
"1758",19026,"Red Cliff, Town of",2010,1,0,457121,438044,895165
"1759",19026,"Red Cliff, Town of",2012,1,0,514800,476062,990862
"1760",19026,"Red Cliff, Town of",2013,1,0,503324,431997,935321
"1761",19026,"Red Cliff, Town of",2014,1,0,494748,384332,879080
"1762",19009,"Eagle, Town of",2012,2,0,2555000,76578,2631578
"1763",19009,"Eagle, Town of",2012,3,0,0,12680431,12680431
"1764",19009,"Eagle, Town of",2011,2,0,2720000,84847,2804847
"1765",19009,"Eagle, Town of",2011,3,0,0,13355829,13355829
"1766",19009,"Eagle, Town of",2010,2,0,2880000,92876,2972876
"1767",19009,"Eagle, Town of",2010,3,0,0,12336373,12336373
"1768",19009,"Eagle, Town of",2014,2,0,2339364,59287,2398651
"1769",19009,"Eagle, Town of",2014,3,0,0,11252627,11252627
"1770",19009,"Eagle, Town of",2013,2,0,2537705,68060,2605765
"1771",19009,"Eagle, Town of",2013,3,0,0,12334535,12334535
"1772",17007,"Rico, Town of",2012,2,14000,0,14122,28122
"1773",17007,"Rico, Town of",2012,3,0,0,0,0
"1774",17007,"Rico, Town of",2010,2,17000,0,31966,48966
"1775",17007,"Rico, Town of",2010,3,0,0,0,0
"1776",17007,"Rico, Town of",2011,2,15500,0,22947,38447
"1777",17007,"Rico, Town of",2011,3,0,0,0,0
"1778",17007,"Rico, Town of",2014,2,8000,0,9509,17509
"1779",17007,"Rico, Town of",2014,3,0,0,0,0
"1780",17007,"Rico, Town of",2013,2,10000,0,11827,21827
"1781",17007,"Rico, Town of",2013,3,0,0,0,0
"1782",15022,"Orchard City, Town of",2010,2,0,0,0,0
"1783",15022,"Orchard City, Town of",2013,2,0,0,0,0
"1784",15022,"Orchard City, Town of",2014,2,0,0,0,0
"1785",15022,"Orchard City, Town of",2011,2,0,0,0,0
"1786",15022,"Orchard City, Town of",2012,2,0,0,0,0
"1787",12001,"Blanca, Town of",2011,1,0,0,0,0
"1788",12001,"Blanca, Town of",2010,1,0,0,0,0
"1789",12001,"Blanca, Town of",2013,1,0,0,298249,298249
"1790",12001,"Blanca, Town of",2014,1,0,0,287597,287597
"1791",12001,"Blanca, Town of",2012,1,0,0,308901,308901
"1792",13006,"Ordway, Town of",2011,2,0,59000,542875,601875
"1793",13006,"Ordway, Town of",2011,3,0,0,583944,583944
"1794",13006,"Ordway, Town of",2010,2,0,77000,569736,646736
"1795",13006,"Ordway, Town of",2010,3,0,0,634804,634804
"1796",13006,"Ordway, Town of",2013,2,0,0,486657,486657
"1797",13006,"Ordway, Town of",2013,3,0,0,479326,479326
"1798",13006,"Ordway, Town of",2012,2,0,40000,515206,555206
"1799",13006,"Ordway, Town of",2012,3,0,0,532133,532133
"1800",13006,"Ordway, Town of",2014,2,0,0,457214,457214
"1801",13006,"Ordway, Town of",2014,3,0,0,425479,425479
"1802",11016,"Sanford, Town of",2010,1,0,0,0,0
"1803",11016,"Sanford, Town of",2014,1,0,0,0,0
"1804",11016,"Sanford, Town of",2012,1,0,0,0,0
"1805",11016,"Sanford, Town of",2011,1,0,0,0,0
"1806",11016,"Sanford, Town of",2013,1,0,0,0,0
"1807",8002,"Buena Vista, Town of",2011,2,0,0,540682,540682
"1808",8002,"Buena Vista, Town of",2010,2,0,0,606888,606888
"1809",8002,"Buena Vista, Town of",2013,2,0,0,397236,397236
"1810",8002,"Buena Vista, Town of",2014,2,0,0,325513,325513
"1811",8002,"Buena Vista, Town of",2012,2,0,0,468959,468959
"1812",8006,"Poncha Springs, Town of",2012,2,0,175000,0,175000
"1813",8006,"Poncha Springs, Town of",2012,3,0,0,0,0
"1814",8006,"Poncha Springs, Town of",2013,2,0,163000,0,163000
"1815",8006,"Poncha Springs, Town of",2010,2,0,198000,0,198000
"1816",8006,"Poncha Springs, Town of",2010,3,0,0,0,0
"1817",8006,"Poncha Springs, Town of",2011,2,0,187000,0,187000
"1818",8006,"Poncha Springs, Town of",2011,3,0,0,0,0
"1819",8006,"Poncha Springs, Town of",2014,2,0,150000,0,150000
"1820",7006,"Boulder, City of",2010,2,0,40415000,0,40415000
"1821",7006,"Boulder, City of",2010,3,0,48228000,0,48228000
"1822",7006,"Boulder, City of",2011,2,0,36659000,0,36659000
"1823",7006,"Boulder, City of",2011,3,0,45745000,0,45745000
"1824",7006,"Boulder, City of",2012,2,0,32697000,0,32697000
"1825",7006,"Boulder, City of",2012,3,0,43354000,0,43354000
"1826",7006,"Boulder, City of",2014,2,0,24841000,0,24841000
"1827",7006,"Boulder, City of",2014,3,0,40047000,0,40047000
"1828",7006,"Boulder, City of",2013,2,0,29303000,0,29303000
"1829",7006,"Boulder, City of",2013,3,0,43283000,0,43283000
"1830",7029,"Louisville, City of",2012,1,0,0,9175562,9175562
"1831",7029,"Louisville, City of",2010,1,0,0,11210833,11210833
"1832",7029,"Louisville, City of",2011,1,0,0,10344947,10344947
"1833",7029,"Louisville, City of",2013,1,0,8355000,222437,8577437
"1834",7029,"Louisville, City of",2014,1,0,7725000,171813,7896813
